scaffold_3	forward	CCCTAACCCTAACCCTAACCCTAACCCTAACCCTAACCCTAACCCTAACCCTAACCCTAACCCTAACCCTAACCCTAGCCCTAAATCTTAATTATACGTA
scaffold_11	forward	CCCTAACCCTAACCCTAACCCTAACCCTAACCCTAACCCTAACCCTAACCCTAACCCTAACCCTAACCCTAACCCTAACCCTACGCTTAAAGCAAGATCG
scaffold_15	forward	ACCCTAACCCTAACCCTAACCCTAACCCTAACCCTAACCCTAACCCTAACCCTAACCCTAACCCTAACCCTAACCCTTCTATACGCTCTATATAAGGGTA
scaffold_29	forward	CCTAACCCTAACCCTAACCCTAACCCTAACCCTAACCCTAACCCTAACCCTAACCCTAACCCTAACCCTAACCCTAATAGCGGAGGTCGGCTTAAGGGCG
scaffold_33	reverse	GATTATACGATCCGCTTCCTATTCGTAGGGTTAGGGTTAGGGTTAGGGTTAGGGTTAGGGTTAGGGTTAGGGTTAGGGTTAGGGTTAGGGTTAGGGTTAG
scaffold_38	reverse	TCGACGTAAGGGCGTAACTCTAAGTTAGGGTTAGGGTTAGGGTTAGGGTTAGGGTTAGGGTTAGGGTTAGGGTTAGGGTTAGGGTTAGGGTTAGGGTTAG
scaffold_45	reverse	TTACTATCGCTATTCTAAAACTACTTAGGGTTAGGGTTAGGGTTAGGGTTAGGGTTAGGGTTAGGGTTAGGGTTAGGGTTAGGGTTAGGGTTAGGGTTAG
scaffold_53	reverse	AGGTAGCGCTAAAGAATAGGTAGATTAGGGTTAGGGTTAGGGTTAGGGTTAGGGTTAGGGTTAGGGTTAGGGTTAGGGTTAGGGTTAGGGTTAGGGTTAG
scaffold_55	forward	CCCTAACCCTAACCCTAACCCTAACCCTAACCCTAACCCTAACCCTAACCCTAACCCTAACCCTAACCCTAGCCCTAGGTTATTTATATACCCTAAGGCG
scaffold_57	forward	CCCTAACCCTAACCCTAACCCTAACCCTAACCCTAACCCTAACCCTAACCCTAACCCTAACCCTAACCCTAACCCTATGAACCTCCAAGACAGCAGTAGT
scaffold_60	forward	TAACCCTAACCCTAACCCTAACCCTAACCCTAACCCTAACCCTAACCCTAACCCTAACCCTAACCCTAACCCTAACCTCTGATTCACCGCTTAAGCATCT
scaffold_87	reverse	TCCTAAGGGCGTCTAGTAAGGGGTTAGGGTTAGGGTTAGGGTTAGGGTTAGGGTTAGGGTTAGGGTTAGGGTTAGGGTTTAGGGTTAGGGTTAGGGTTAG
scaffold_123	forward	CTAACCCTAACCCTAACCCTAACCCTAACCCTAACCCTAACCCTAACCCTAACCCTAACCCTAAACCCTAACCCTAACCCTAACCCTAACCCTAACCCTA
scaffold_141	reverse	TTAGTATATTATAGGGTAATATAATTAGGGTTAGGGTTAGGGTTAGGGTTAGGGTTAGGGTTAGGGTTAGGGTTAGGGTTAGGGTTAGGGTTAGGGTTAG
scaffold_142	reverse	CGGCGTAGCGCTTAGTATAAGGCGGGTTAGGGTTAGGGTTAGGGTTAGGGTTAGGGTTAGGGTTAGGGTTAGGGTTAGGGTTAGGGTTAGGGTTAGGGTT
scaffold_159	reverse	CCGTAGTCCGCTACCGTACTAATATAGGGTTAGGGTTAGGGTTAGGGTTAGGGTTAGGGTTAGGGTTAGGGTTAGGGTTAGGGTTAGGGTTAGGGTTAGG
scaffold_163	forward	ACCCTAACCCTAACCCTAACCCTAACCCTAACCCTAACCCTAACCCTAACCCTAACCCTAACCCTAACCCTAACCCTGAGTTAGCGCCGTAATCGACTAG
scaffold_164	forward	CTAACCCTAACCCTAACCCTAACCCTAACCCTAACCCTAACCCTAACCCTAACCCTAACCCTAACCCTAACCCTAAGGAACTCTTAGCTATCGTTAAAGC
scaffold_167	forward	TAAGAACGTAGTATAAAGTAACTAACTCCTAACTCTATATTATATAACTACTAAAGCCTTATATATAATTACGTAATCTCGGGGATACCTAGACTCCCGC
scaffold_204	reverse	CGCCTTCGTTTTTGGAGCCGACGAGGGTTAGGGTTAGGGTTAGGGTTAGGGTTAGGGTTAGGGTTAGGGTTAGGGTTAGGGTTAGGGTTAGGGTTAGGGT
scaffold_213	reverse	AGTTCTATACGATCTTACGCGAGCCTTAGGGTTAGGGTTAGGGTTAGGGTTAGGGTTAGGGTTAGGGTTAGGGTTAGGGTTAGGGTTAGGGTTAGGGTTA
scaffold_242	forward	ACCCTAACCCTAACCCTAACCCTAACCCTAACCCTAACCCTAACCCTAACCCTAACCCTAACCCTAACCCTAACCCCTTACGAGCTATTATAGGTAGCTC
scaffold_246	reverse	GGTGGAAACCCTCCGGATTGGTGGGGTTAGGGTTAGGGTTAGGGTTAGGGTTAGGGTTAGGGTTAGGGTTAGGGTTAGGGTTAGGGTTAGGGTTAGGGTT
scaffold_247	reverse	CTTTATAGTTAATCTACTACTAAGTAGGGTTAGGGTTAGGGTTAGGGTTAGGGTTAGGGTTAGGGTTAGGGTTAGGGTTAGGGTTAGGGTTAGGGTTAGG
scaffold_259	forward	CCTAACCCTAACCCTAACCCTAACCCTAACCCTAACCCTAACCCTAACCCTAACCCTAACCCTAACCCTAACCCTAAGCGTCGCTAGGCTGTAACTCGTG
scaffold_269	forward	ACGTAGTATAAAGTAACTAACTCCTAACTCTATATTATATAACTACTAAAGCCTTATATATAATTACGTAATCTCGGAGATACCTAGACTCCCGCTTTCT
scaffold_275	forward	CCTAACCCTAACCCTAACCCTAACCCTAACCCTAACCCTAACCCTAACCCTAACCCTAACCCTAACCCTAACCCTATCGCTACCGCTAGCTAGTAAGAAG
scaffold_286	reverse	AGCGATGTTGTGGTGATTAGCTTAGGGGTTAGGGTTAGGGTTAGGGTTAGGGTTAGGGTTAGGGTTAGGGTTAGGGTTAGGGTTAGGGTTAGGGTTAGGG
scaffold_307	forward	TAGTACTAAGGGGGGTATAACTAACTTCTCTACCCTTAATTCCCTTTCCTTCCCCTTATAGGGTATAGTTTCTCTACCGCTATAGGCGGTAGTCTCTCCT
scaffold_324	reverse	TCGAAGAACTAAAGACTACGCTTGGGTTAGGGTTAGGGTTAGGGTTAGGGTTAGGGTTAGGGTTAGGGTTAGGGTTAGGGTTAGGGTTAGGGTTAGGGTT
scaffold_331	forward	TAACCCTAACCCTAACCCTAACCCTAACCCTAACCCTAACCCTAACCCTAACCCTAACCCTAACCCTAACCCTAAGATGAGGGAAGTGTACAGCAAGTCG
scaffold_345	forward	AACCCTAACCCTAACCCTAACCCTAACCCTAACCCTAACCCTAACCCTAACCCTAACCCTAACCCTAACCCTAACCTTAACCCTAACCTTAACCTTACTT
scaffold_362	forward	TAACCCTAACCCTAACCCTAACCCTAACCCTAACCCTAACCCTAACCCTAACCCTAACCCTAACCCTAACCCTAACCAGCTACTATAGTAAGCGGCGGAA
scaffold_371	reverse	CGACTAGCGCCCGGTCTTAGGGTTTAGGGGTTAGGGTTAGGGTTAGGGTTAGGGTTAGGGTTAGGGTTAGGGTTAGGGTTAGGGTTAGGGTTAGGGTTAG
scaffold_380	forward	CTAACCCTAACCCTAACCCTAACCCTAACCCTAACCCTAACCCTAACCCTAACCCTAACCCTAACCCTAACCCTAAGAAACTATCCCTACCGCCTATAGT
scaffold_405	reverse	TCTATCTACTTACTAATGGGTTAAGATTAGGGTTAGGGTTAGGGTTAGGGTTAGGGTTAGGGTTAGGGTTAGGGTTAGGGTTAGGGTTAGGGTTAGGGTT
scaffold_428	reverse	TATAAACTAGGATATAGAGCAAGGATTAGGGTTAGGGTTAGGGTTAGGGTTAGGGTTAGGGTTAGGGTTAGGGTTAGGGTTAGGGTTAGGGTTAGGGTTA
scaffold_443	reverse	AGCTATCGTAGGTAGCTCCGTAATAGATTAGGGTTAGGGTTAGGGTTAGGGTTAGGGTTAGGGTTAGGGTTAGGGTTAGGGTTAGGGTTAGGGTTAGGGT
scaffold_454	reverse	ATATTATTACCGCTACTATTGTCGTTAGGGTTAGGGTTAGGGTTAGGGTTAGGGTTAGGGTTAGGGTTAGGGTTAGGGTTAGGGTTAGGGTTAGGGTTAG
scaffold_475	forward	ACCCTAACCCTAACCCTAACCCTAACCCTAACCCTAACCCTAACCCTAACCCTAACCCTAACCCTAACCCTAATCCTAAGATCTCTAAAATATACTAGAC
scaffold_482	forward	CCCTAACCCTAACCCTAACCCTAACCCTAACCCTAACCCTAACCCTAACCCTAACCCTAACCCTAACCCTAACCCTTGCCCTTGTCGTAGCGTAGCGGAA
scaffold_489	reverse	AAGGATATATTATAATAATAAATAAGGGTTAGGGTTAGGGTTAGGGTTAGGGTTAGGGTTAGGGTTAGGGTTAGGGTTAGGGTTAGGGTTAGGGTTAGGG
scaffold_529	forward	ACCCTAACCCTAACCCTAACCCTAACCCTAACCCTAACCCTAACCCTAACCCTAACCCTAACCCTAACCCTAACCTTTATTATATACTCCTACTATAGCT
scaffold_564	reverse	CTAGTCTCTAGAGGTATAATACTCGCTTAGGGTTAGGGTTAGGGTTAGGGTTAGGGTTAGGGTTAGGGTTAGGGTTAGGGTTAGGGTTAGGGTTAGGGTT
scaffold_570	reverse	GGGAGATGTTGTTGTAGGCTACTAGGATGCCTTGGGTTGGGTAGTTTAGGGTTTCGTAGCGGGCGTCGGTTGGCTTTGGGCGGGTTAGTTAGACGCGGGG
scaffold_586	reverse	CTATACTCTACCTTTATACTATAGTATAGGGTTAGGGTTAGGGTTAGGGTTAGGGTTAGGGTTAGGGTTAGGGTTAGGGTTAGGGTTAGGGTTAGGGTTA
scaffold_588	reverse	CTTATTAAACTCGGTACCCTACTATCTTAGGGTTAGGGTTAGGGTTAGGGTTAGGGTTAGGGTTAGGGTTAGGGTTAGGGTTAGGGTTAGGGTTAGGGTT
scaffold_628	reverse	CTAGATACGGTTAAAGTCGGCTACGTAGGGTTAGGGTTAGGGTTAGGGTTAGGGTTAGGGTTAGGGTTAGGGTTAGGGTTAGGGTTAGGGTTAGGGTTAG
scaffold_725	forward	GATAGGAACCTTACTAGAAGCGCCGCTAAGGGCCCCTACGCTAAGTCATTAGGTCTTAGCACTAAGGGGGGTATAACTAACTTCTCTACCCTTAATTTCC

Telomeres found: 49 (24 forward, 25 reverse)
