scaffold_13	forward	AACCCTAACCCTAACCCTAACCCTAACCCTAACCCTAACCCTAACCCTAACCCTAACCCTAACCCTAACCCTAACCCTAACCCTAACCCTATCTCATTTG
scaffold_37	reverse	AATAATTTTGTTAGGGTTAGGGTTAGGGTTAGGGTTAGGGTTAGGGTTAGGGTTAGGGTTAGGGTTAGGGTTAGGGTTAGGGTTAGGGTTAGGGTTAGGG
scaffold_42	forward	TAACCCTAACCCTAACCCTAACCCTAACCCTAACCCTAACCCTAACCCTAACCCTAACCCTAACCCTAACCCTAACCCTAACCCTAACCCTCATGACTGT
scaffold_47	reverse	AGTTAGTTATAACTTTAATTTTAACACATGATCAAATTGCTGTGATATGATTGCTTAACTAAAATCATATGACACTTTTAAAGTTTATGCTATAAAAATG
scaffold_62	forward	ACCCTAACCCTAACCCTAACCCTAACCCTAACCCTAACCCTAACCCTAACCCTAACCCTAACCCTAACCCTAACCCTAACCCTAACCCTAAGCGAACTGT
scaffold_96	forward	CCCTAACCCTAACCCTAACCCTAACCCTAACCCTAACCCTAAACCCTAACCCTAACCCTAACCCTAACCCTAACCCTAACCCTAACCCTAACCCTAACCC
scaffold_119	reverse	TTCTCAGGGTTAGGGTTAGGGTTAGGGGTTAGGGTTAGGGTTAGGGTTAGGGTTAGGGTTAGGGTTAGGGTTAGGGTTAGGGTTAGGGTTAGGGTTAGGG
scaffold_129	reverse	GGTGAAACAAGCTTAGGGTTAGGGTTAGGGTTAGGGTTAGGGTTAGGGTTAGGGTTAGGGTTAGGGTTAGGGTTAGGGTTAGGGTTAGGGTTAGGGTTAG
scaffold_181	reverse	GTTTCAGGTTCAGGGTTAGGGTTAGGGTTAGGGTTAGGGTTAGGGTTAGGGTTAGGGTTAGGGTTAGGGTTAGGGTTAGGGTTAGGGTTAGGGTTAGGGT
scaffold_278	reverse	CTCACACTCAGGGTTAGGGTTAGGGTTAGGGTTAGGGTTAGGGTTAGGGTTAGGGTTAGGGTTAGGGTTAGGGTTAGGGTTAGGGTTAGGGTTAGGGTTA
scaffold_296	forward	AACCCTAACCCTAACCCTAAACCCTAACCCTAACCCTAACCCTAACCCTAACCCTAACCCTAACCCTAACCCTAACCCTAACCCTAACCCTGATATTCCT
scaffold_312	reverse	AAACACATTTAAAAGGGTTAGGGTTAGGGTTAGGGTTAGGGTTAGGGTTAGGGTTAGGGTTAGGGTTAGGGTTAGGGTTAGGGTTAGGGTTAGGGTTAGG
scaffold_341	forward	CCCTAACCCTAACCCTAACCCTAACCCTAACCCTAACCCTAACCCTAACCCTAACCCTAACCCTAACCCTAACCCTAACCCTAACCCTAAGGACTGATGA
scaffold_347	forward	CCTAACCCTAACCCTAACCCTAACCCTAACCCTAACCCTAACCCTAACCCTAACCCTAACCCTAACCCTAACCCTAACCCTAACCCTAAGCATCCTCACT
scaffold_415	forward	TGTTTTTCCTTATAGCAATTAACTAACTAGCTGTATAGCCTTTAAGATGAATCGAACATCTGTCTAAATATTAACAGTATTTAGCTCTACCGTTGAGCTA
scaffold_417	forward	CCCTAACCCTAACCCTAACCCTAACCCTAACCCTAACCCTAACCCTAACCCTAACCCTAACCCTAACCCTAACCCTAACCCTAACCCTAAGTGGTTCAAA
scaffold_435	forward	AACCCTAACCCTAACCCTAACCCTAACCCTAACCCTAACCCTAACCCTAACCCTAACCCTAACCCTAACCCTAACCCTAACCCTAACCCTAGATATAGTT
scaffold_530	forward	CCCTAACCCTAACCCTAACCCTAACCCTAACCCTAACCCTAACCCTAACCCTAACCCTAACCCTAACCCTAACCCTAACCCAGCTTTCATTACAACAACC
scaffold_554	forward	ACCCTAACCCTAACCCTAACCCTAACCCTAACCCTAACCCTAACCCTAACCCTAACCCTAACCCTAACCCTAACCCTAACCCTAACCCTAATAGCGATTG
scaffold_556	reverse	CACCGCTACGCGGGTTAGGGTTAGGGTTAGGGTTAGGGTTAGGGTTAGGGTTAGGGTTAGGGTTAGGGTTAGGGTTAGGGTTAGGGTTAGGGTTAGGGTT
scaffold_586	reverse	GATAATTGGCTAAGAATTTAGTAGCATGTTAGTTATAACTTTAATTTAATCATGTGGTTAAATTGCTATGATATGATTGCTTAAATGAAATCATATGACA
scaffold_594	forward	ATGAGACAAGAAGAAGAGACTCACTCTCATTGAGATGAAGTCATGATTGTTTATAACTAACTCAGTCATGAGAAGCAGGCTTGCTTAGTTGTTCTGACTA

Telomeres found: 22 (13 forward, 9 reverse)
