scaffold_50	reverse	CCCGTACGTAAGCTTTCGGGTATTAGGGTTAGGGTTAGGGTTAGGGTTAGGGTTAGGGTTAGGGTTAGGGTTAGGGTTAGGGTTAGGGTTAGGGTTAGGG
scaffold_54	forward	CCCTAACCCTAACCCTAACCCTAACCCTAACCCTAACCCTAACCCTAACCCTAACCCTAACCCTAACCCTAACCCTAACCCTAACCCTAACCCTAAGACT
scaffold_66	reverse	GGCTTTATACCTTCTTAGAAAGCTCTTTAGGCGTGCGAACTTTATTTAGGGTTAGGGTTAGGGTTAGGGTTAGGGTTAGGGTTAGGGTTAGGGTTAGGGT
scaffold_73	forward	ACCCTAACCCTAACCCTAACCCTAACCCTAACCCTAACCCTAACCCTAACCCTAACCCTAACCCTAACCCTAACCCTAACCCTAAGAAGCTCCTTAGATA
scaffold_96	forward	CCCTAACCCTAACCCTAACCCTAACCCTAACCCTAACCCTAACCCTAACCCTAACCCTAACCCTAACCCTAACCCTAACCCTAATACCGATAGTATAGAA
scaffold_99	forward	CCCTAACCCTAACCCTAACCCTAACCCTAACCCTAACCCTAACCCTAACCCTAACCCTAACCCTAACCCTAACCCTAACTCTCTTCTCTTATATCTTTCT
scaffold_109	forward	CCCTAACCCTAACCCTAACCCTAACCCTAACCCTAACCCTAACCCTAACCCTAACCCTAACCCTATACTATTTATAGTAAGGCTTTAATAGTTATATCCG
scaffold_117	forward	ACCCTAACCCTAACCCTAACCCTAACCCTTAACCCTAACCCTAACCCTAACCCTAACCCTAACCCTAACCCTAACCCGTACCCGCCTTAGGTTACCCGTA
scaffold_118	forward	CCCTAACCCTAACCCTAACCCTAACCCTAACCCTAACCCTAACCCTAACCCTAACCCTAACCCTAACCCTAACCCTAATTTATATACTTTAGTTATACTA
scaffold_134	reverse	AGTATAAAATAGGTTAAGGTTAGGGTTAGATGCTAGGGATTATGGTTAGTATAGTATATATATATAATCGGTTTAGAACTAGTTACGAACTAGCTAGAGT
scaffold_147	reverse	AGGTTTAGGTTTTGGGTTAGGGTTTGGGTTAGGGTTAGGGTTAGGGTGAGGGTTAGGGTTAGGGTTAGGGTTAGGGTTAGGGTTAGGGTTAGGGTTAGGG
scaffold_160	forward	ACCCTAACCCTAACCCTAACCCTAACCCTAACCCTAACCCTAACCCTAACCCTAACCCTAACCCTAACCCTAACCCTAACCCTAACCCTAAATAGCGCTC
scaffold_170	reverse	GACATTGTGTCAACCTTCTGTAGGTCTCTTAGGGTTAGGGTTAGGGTTAGGGTTAGGGTTAGGGTTAGGGTTAGGGTTAGGGTTAGGGTTAGGGTTAGGG
scaffold_171	reverse	GTAATTACTTAGAGACAAGCGCTATTTAGCTCTTAGGGTTAGGGTTAGGGTTAGGGTTAGGGTTAGGGTTAGGGTTAGGGTTAGGGTTAGGGTTAGGGTT
scaffold_172	forward	CCCTAACCCTAACCCTAACCCTAACCCTAACCCTAACCCTAACCCTAACCCTAACCCTAACCCTAACCCTAACCCTTATTACGGCGTTATATCTTATTTC
scaffold_188	forward	CCCTAACCCTAACCCTAACCCTAACCCTAACCCTAACCCTAACCCTAACCCTAACCCTAACCCTAACCCTAACCCTAATAGTATAGAAGAGAAGTCTCTT
scaffold_194	forward	ACCGGTTCTTAATTTCTATAAAACTAGCTAATCTAGCTAGTTCGTAACTAATACTAAACCGGTGTTATATATATATATATACTATACTAACCCTAACCTA
scaffold_216	forward	TCGCTAGTAAACGTGATTATAACTAACTTAATAACCTAGAAGTAATTCTAACTACCGAGGTGGTTAGAGACTTAAGTGTTTATAGTACTACTATACTAAA
scaffold_244	forward	TAACCCTAACTGCACTCACTTTTGGGACGCCTCCGTAGCATGCGCAACACTTAAGTTGTATAGTTCCGTACCTCATTCCCAGTTCGATGCTGTTCCCATC
scaffold_277	reverse	TATAAGGCCGTTAGGGTTAGGGTTAGGGTTAGGGTTAGGGTTAGGGTTAGGGTTAGGGTTAGGGTTAGGTTTAGGGTTAGGGTTAGGGTTAGGGTTAGGG
scaffold_289	forward	CCCTAACCCTAACCCTAACCCTAACCCTAACCCTAACCCTAACCCTAACCCTAACCCTAACCCTAACCCTAACCCTAACCCTAACCATAACCCTACCCCT
scaffold_294	reverse	AGGGTTAGGGTTAGGGTTAGGGTTAGGGTTAGGGTTAGGGTTAGGGTTAGGGTTAGGGTTAGGGTTAGGGTTAGGGTTAGGGTTAGGGTTAGGGTTAGGG
scaffold_341	reverse	AAACGTTAGTTAAAACGCCTTTTCTTCCTATATCGGTAAAGATAATAGGCATATTACCTATACCACTAGCCTTAATTCGAGTAGTCTCACCCCACTTAAT
scaffold_348	forward	CCCCTAACCCTAACCCTAACCCCTAACCCCTAACCTCTAACCCTAACCTAACCCGAACCCTAACCTATTTTATACTAGTTTAGAACCGGTTAAGAACTAG
scaffold_545	forward	AGGCTAGTGGTATAGGGAATATCCCTATTATCTTTACCGATATAGGAAGAAAAGGCGTTTTAACTAACGTTTTATTCGTACCTAAATTCGAAGTTAATCT
scaffold_641	reverse	ATAGTTTTAATAAGTTAACCGTAGAAGAAATTCACTAGACTATTATAAGGTTAGTTAAAATTATTCTTTTTTATCGTTTAAGTTAAAATTCTTTATCGTA
scaffold_720	forward	GATTAACTGACTAGCAGTACGAATTCAACTAGCAATACTATACTTGATTAACTAACTAGCAATTACTATAGTCGATTAAGGAGGAATTCGACTCGTGTAG
scaffold_762	forward	ACCCGATACCCTACTAATACCCGATACCCGACCCGACACTAATAGCGTATGCAGTATAAGCACTAACTAACTGACTAGCAGTACTGACTGACTAACTAGC
scaffold_972	reverse	GAAATTCACTAGACTATTATAAGGTTAGTTAAAATTATCCTTTTTTATCGTTTAAGTTAAAATTCTTTATCGTAAGCTCCTATTCTCTTACCTAAGATAG
scaffold_979	reverse	TAGTAGGTATTAGTATATTAGCGATAGCCTTCTCTATATATATTATTATATCGTTCTACGATATTCTAGCGCGCACTAGAGATCTTAAGGTCGTTAGTTA
scaffold_1007	reverse	TTTTTATAAGTTAACCTTAGAAGAAATTCACTAAACTATTATAAGGTTAGTTAAAATTATCTTTTTTTATCGTTTAAGTTAAAATTCTTTATCGTAAGCT
scaffold_1017	forward	TTTACTAATGAAGATGCTTTGCTCTACTATTATCCTTTCGCTAGTACACGTGAGTCTAACTAACTTAATAACCTAGAAGTAATTCTAACTACCGAGGTGG
scaffold_1027	forward	TTTAATAAAAGAAGCTACTACTACTAACTAACCTCTTTTAGAAAGAGCTAACGTAGAGCTTCTAAGGAGTTCTATAACCGCTATAGTCGTAGTATAGTTA
scaffold_1039	forward	CCCTAACCCTAACCCTAACCCTAACCCTAACCCTAACCCTAACCCTAACTAACCCTCATCTATTTTACCTAACCCGTACCCACGGCCTCGAGGTATACCT
scaffold_1070	reverse	TACTATTAAGCTACTATTTATTTTTATTACCTATTTAGGGTTAGGGTTAGGGTTAGGGTTAGGGTTAGGGTTAGGGTTAGGGTTAGGGTTAGGGTTAGGG
scaffold_1087	reverse	ACCTAGAAGTAATTCTAACTACCGAGGTAGTTAGAGACTTAAGTGTTTATAGCACTACTACCCTAAACAGTGCTAGTTAGTTACTAGATTCGGGAGCTAG
scaffold_1092	reverse	GTTAGTTAAAGTAGAATATTCCTTTTATAAGTTAACTTAATACTAGCGTCGAAGCTATAATTAAGAAGCTTAAAGAGTATTATAGTTAGACGTATAGTAA
scaffold_1146	forward	ACCCTAACCCTAACCCTAACCCTAACCCTAACCCTAACCCTAACCCTAACCCTAACCCTAACCCTAAGATACGGGTCGATTAAAGCCTATAGTTAATAAA
scaffold_1185	forward	CCCTAACCCTAACCCTAACCCTAACCCTAACCCTAACCCTAACCCTAACCCTAACCCTAACCCTAACCCTAAGATAAAATATTCTAGCTTAGGTTAAGTA
scaffold_1205	reverse	ATTATTTCTCGTAGAAGTATAGTACTATAACTTATTAGGGTTAGGGTTAGGGTTAGGGTTAGGGTTAGGGTTAGGGTTAGGGTTAGGGTTAGGGTTAGGG
scaffold_1315	forward	TACGATAAAGAATTTTAACTTAAACGATAAAAAAGAATAATTTTAACTAACCTTATAATAGTCTAGTGAATTTCTTCTACGGTTAACTTATTAAAACTAT
scaffold_1324	reverse	GAAATTCACTAGACTATTATAAGGTTAGTTAAAATTATCCTTTTTTATCGTTTAAGTTAAAATTCTTTATCGTAAGCTCCTATTCTCTTACCTAAGATAG
scaffold_1327	reverse	TAGTAGGTATTAGTATATTAGCGATAGCCTTCTCTATATATATTATTATATCGTCTTACGATATTCTAGCGCGCACTAGAGATCTTAAGGTCGTTAGTTA
scaffold_1397	reverse	ATAATTCGGGAAAAAGAAGCGTTAGTTAAAGCAGAATATTCCTTTTATAAGTTAACTTAATACTAGCGTCGAAGCTATAATTAAAAAGCTTAAAGAGTAT
scaffold_1405	reverse	AGAGATCTTAAGGTCGTTAGTTAGTTACGACCTAAGAGCGCCTTAACTTCTAGGTTAGTAACGACTCGCTAAAGCTACGTCTATAACCTAATCTCTTCGA
scaffold_1471	reverse	TAGTACTATTAACACTTAAGTCTCTAACCACCTCGGTAGTTAGAATTACTTCTAGGTTATTAAGTTAGTTATAATCACGTTTACTAGCGAATGGAGAATA
scaffold_1480	forward	CCCTAACCCTAACCCTAACCCTAACCCTAACCCTAACCCTAACCCTAACCCTATCCCTAACCCTAACCCTAACCCTAACCCTAACCCTAACCCTAATAGA
scaffold_1481	reverse	ATAGCGGCACTACTTAAATAATATATAAGATACTATAGATAAGAATAGGGTTAGGGTTAGGGTTAGGGTTAGGGTTATGGTTAGGGTTAGGGTTAGGGTT

Telomeres found: 48 (25 forward, 23 reverse)
