scaffold_1	reverse	TGCAATCTCTATAGTAGTTAGTTAGTATAACTAATAAAATTTTTATTTACTTAATAGTTTTATAGGTTATAAGCCCGGCTTAACGTCTTTAGAACGTATA
scaffold_2	reverse	TAGAGAATTTTAGGGTTAGGGTTAGGGTTAGGGTTAGGGTTAGGGTTAGGGTTAGGGTTAGGGTTAGGGTTAGGGTTAGGGTTAGGGTTAGGGTTAGGGT
scaffold_13	reverse	TTACTAGAGCTAGAGTTAGTTACTAGAGCTAGAGTTAGTTACTAGAGCTAGAGTTAGTTACTAGAGCTAGAGTTAGTTACTAGAGCTAGAGTTAGTTACT
scaffold_17	forward	CCCTAACCCTAACCCTAACCCTAACCCTAACCCTAACCCTAACCCTAACCCTAACCCTAACCCTAACCCTAACCCTAACCCTAACCCTAACTAGATATAT
scaffold_19	forward	ACCCTAACCCTAACCCTAACCCTAACCCTAACCCTAACCCTAACCCTAACCCTAACCCTAACCCTAACCCTAACCCTAACCCTAACCCTAATTAACCCTA
scaffold_31	reverse	TTAAACTTCCTTAGGGTTAGGGTTAGGGTTAGGGTTAGGGTTAGGGTTAGGGTTAGGGTTAGGGTTAGGGTTAGGGTTAGGGTTAGGGTTAGGGTTAGGG
scaffold_33	forward	CCTAACCCTAACCCTAACCCTAACCCTAACCCTAACCCTAACCCTAACCCTAACCCTAACCCTAACCCTAACCCTAACCCTAACCCTAAGTTATTAATTA
scaffold_38	forward	TAACCCTAACCCTAACCCTAACCCTAACCCTAACCCTAACCCTAACCCTAACCCTAACCCTAACCCTAACCCTAACCCTAACCCTAAGTTAAAAACCGAA
scaffold_44	forward	ATTTATTTATTTAAGCTTAAAAGAGCCGAGTTAACTAACTATCCTAAAAATTAGAAAGTATACTATTCGTAAGATATTAGAAACCTAGTCGCAAGACCTT
scaffold_59	reverse	TAAGGCGGGTAGGGTTAGGGTTAGGGTTAGGGTTAGGGTTAGGGTTAGGGTTAGGGTTAGGGTTAGGGTTAGGGTTAGGGTTAGGGTTAGGGTTAGGGTT
scaffold_69	forward	CCTAACCCTAACCCTAACCCTAACCCTAACCCTAACCCTAACCCTAACCCTAACCCTAACCCTAACCCTAACCCTAACCCTAACCCTAAGACTATAACTT
scaffold_86	reverse	CTAACCCTATTTAGGGTTAGGGTTAGGGTTAGGGTTAGGGTTAGGGTTAGGGTTAGGGTTAGGGTTAGGGTTAGGGTTAGGGTTAGGGTTAGGGTTAGGG
scaffold_105	reverse	CTTAGAGTTAAGCTTAGGGTTAGGGTTAGGGTTAGGGTTAGGGTTAGGGTTAGGGTTAGGGTTAGGGTTAGGGTTAGGGTTAGGGTTAGGGTTAGGGTTA
scaffold_107	forward	CTAACCCTAACCCTAACCCTAACCCTAACCCTAACCCTAACCCTAACCCTAACCCTAACCCTAACCCTAACCCTAACCCTAACCCTAAGTAGCTATTTTT
scaffold_115	forward	AACCCTAACCCTAACCCTAACCCTAACCCTAACCCTAACCCTAACCCTAACCCTAACCCTAACCCTAACCCTAACCCTAACTAACCCTAACTAACCCTAA
scaffold_126	reverse	TTGGATTTGAGTTAGGGTTAGGGTTAGGGTTAGGGTTAGGGTTAGGGTTAGGGTTAGGGTTAGGGTTAGGGTTAGGGTTAGGGTTAGGGTTAGGGTTAGG
scaffold_133	reverse	AGTATTAGTGTTAGGGTTAGGGTTAGGGTTAGGGTTAGGGTTAGGGTTAGGGTTAGGGTTAGGGTTAGGGTTAGGGTTAGGGTTAGGGTTAGGGTTAGGG
scaffold_149	reverse	TTTATAATTATTAGGGTTAGGGTTAGGGTTAGGGTTAGGGTTAGGGTTAGGGTTAGGGTTAGGGTTAGGGTTAGGGTTAGGGTTAGGGTTAGGGTTAGGG
scaffold_185	forward	CCTAACCCTAACCCTAACCCTAACCCTAACCCTAACCCTAACCCTAACCCTAACCCTAACCCTAACCCTAACTAACCCTAACTAACCCTAACTAACCCAC
scaffold_226	forward	ACCCTAACCCTAACCCTAACCCTAACCCTAACCCTAACCCTAACCCTAACCCTAACCCTAACCCTAACCCTAACCCTAACCCTAACCCTAAGTATTACTA
scaffold_342	forward	ATAAGGCTATTAGGTCGAAGAATCAGGACGATTAGCTTCGCGTAATAGAGTTAGAATTATAGTCTCTCGAAAAGAATAAGACTTAGTAACTAACTAAATT
scaffold_405	reverse	ACTAGGTTAGGTTAGGTAGTGGGTAGGTATGGGTAGAAAATCCCTATTTTCCACCCACTACCCAGGTGGGTACCTAGTGGGTACTAAGCATAGACTAGCT
scaffold_415	forward	TAACCCTAACCCTAACCCTAACCCTAACCCTAACCCTAACCCTAACCCTAACCCTAACCCTAACCCTAACCCTAACCCTAACCCTAACTAAGCCTTATAC
scaffold_428	forward	ACCCTAACCCTAACCCTAACCCTAACCCTAACCCTAACCCTAACCCTAACCCTAACCCTAACCCTAACCCTAACCCTAACCCTAACCCTATTTTAGCCTT
scaffold_477	reverse	TAGATAGGGGGGTTAGGGTTAGGGTTAGGGTTAGGGTTAGGGTTAGGGTTAGGGTTAGGGTTAGGGTTAGGGTTAGGGTTAGGGTTAGGGTTAGGGTTAG
scaffold_494	reverse	CGCGATAAGGTCTATCGAATACGTCCTATAGATATTAGCGGCCGAACTTAATAACTTCTAGTTCTCCGCGAGTTAGTTATAGATACTAAACTAGCTAATA

Telomeres found: 26 (13 forward, 13 reverse)
