scaffold_1	reverse	ATATATACCGTATCTGCAATCTCTATAGTAGTTAGTTAGTATAACTAATAAAATTTTTATTTACTTAATAGTTTTATAGGTTATAAGCCCGGCTTAACGT
scaffold_16	forward	CCTAACCCTAACCCTAACCCTAACCCTAACCCTAACCCTAACCCTAACCCTAACCCTAACCCTAACCCTAACCCTAATTTCTAAAAAAGACTAAGTAATT
scaffold_22	reverse	TAGGGTTAGGGTTAGGGTTAGGGTTAGGGTTAGGGTTAGGGTTAGGGTTAGGGTTAGGGTTAGGGTTAGGGTTAGGGTTAGGGTTAGGGTTAGGGTTAGG
scaffold_26	forward	AACCCTAACCCTAACCCTAACCCTAACCCTAACCCTAACCCTAACCCTAACCCTAACCCTAACCCTAACCCTAACTAAGCCTTATACGGTTCTATAACGT
scaffold_29	reverse	TAATCTAGTTTATTATCGTTAAAATCTTAGGGTTAGGGTTAGGGTTAGGGTTAGGGTTAGGGTTAGGGTTAGGGTTAGGGTTAGGGTTAGGGTTAGGGTT
scaffold_32	forward	CCTAACCCTAACCCTAACCCTAACCCTAACCCTAACCCTAACCCTAACCCTAACCCTAACCCTAACCCTAACCCTATTTTAGCCTTAGTAATAGGATCTA
scaffold_34	forward	TAACCCTAACCCTAACCCTAACCCTAACCCTAACCCTAACCCTAACCCTAACCCTAACCCTAACCCTAACCCTAATTAACCCTATAGATATAGTGGTTAT
scaffold_37	forward	TAACCCTAACCCTAACCCTAACCCTAACCCTAACCCTAACCCTAACCCTAACCCTAACCCTAACCCTAACCCTAAGACTATAACTTTCGTAATACTAGGC
scaffold_39	forward	ACCCTAACCCTAACCCTAACCCTAACCCTAACCCTAACCCTAACCCTAACCCTAACCCTAACCCTAACCCTAACCCTTAAAAAGCCCGAAGACACCGAAG
scaffold_43	forward	CTAACCCTAACCCTAACCCTAACCCTAACCCTAACCCTAACCCTAACCCTAACCCTAACCCTAACCCTAACCCTAAACTAACCCTAACTAACCCTAACTA
scaffold_45	reverse	TATATAACTCGCTTCTATTAGAATAGTTAGGGTTAGGGTTAGGGTTAGGGTTAGGGTTAGGGTTAGGGTTAGGGTTAGGGTTAGGGTTAGGGTTAGGGTT
scaffold_59	reverse	TAGGTACGGGTAACCTAAGGCGGGTAGGGTTAGGGTTAGGGTTAGGGTTAGGGTTAGGGTTAGGGTTAGGGTTAGGGTTAGGGTTAGGGTTAGGGTTAGG
scaffold_63	forward	GCTTAAAAGAGCCGAGTTAACTAACTATCCTAAAAATTAGAAAGTATACTATTCGTAAGATATTAGAAACCTAGTCGCAAGACCTTAAAGTGCTAGAAAG
scaffold_69	reverse	AGACCCCCTTATACCACTCTAGCGAATAGGGTTAGGGTTAGGGTTAGGGTTAGGGTTAGGGTTAGGGTTAGGGTTAGGGTTAGGGTTAGGGTTAGGGTTA
scaffold_70	reverse	AAGGACGTTATAAAAATAGCTACTTAGGGTTAGGGTTAGGGTTAGGGTTAGGGTTAGGGTTAGGGTTAGGGTTAGGGTTAGGGTTAGGGTTAGGGTTAGG
scaffold_73	forward	AGTCGAATTAAGTTAACTAACGTCTATTCGTAGAAGCTAGTGCTAAGCTATTAATTTAGTATAGCCTACTAGTTCTTTAATACCGTATTTATATAGGTTA
scaffold_86	forward	CACACACACACACACACACACACAGGTCCTCGCACCGATGGTTGACCTCGCACACCTAACCTAACCCAGATATGCTGTCGCACGCTCCCCCGTCGCACGC
scaffold_91	reverse	AAATAGGCTAAGGGCTATGCCTATTTAGGGTTAGGGTTAGGGTTAGGGTTAGGGTTAGGGTTAGGGTTAGGGTTAGGGTTAGGGTTAGGGTTAGGGTTAG
scaffold_94	forward	TAGTACCCACTAGGTACCCACCTGGGTAGTGGGTGGAAAATAGGGATTTTCTACCCACACCTACCCACTACCTAACCTAACCTAGTGCTAAGTACCTACT
scaffold_100	forward	TATAATAATAGTCGCTATTCGGCTACTAGTAATACGCCGTTCTTTCTTAACTATTTTCGTTACTCGCGATTCTTAATTAACGTAATAACTAACTTATATA
scaffold_108	forward	CTAACCCTAACCCTAACCCTAACCCTAACCCTAACCCTAACCCTAACCCTAACCCTAACCCTAACCCTAACCCTAATCCAAATCCAAATCCAAATCCAAA
scaffold_114	reverse	TTTCTCCTCAGCCTTAGTTATAGTATTAGGGTTAGGGTTAGGGTTAGGGTTAGGGTTAGGGTTAGGGTTAGGGTTAGGGTTAGGGTTAGGGTTAGGGTTA
scaffold_290	forward	TAGTCCCCGAAGCTACTTAGACCGGATTTTAAGCTAATTCCGACCTTAACTAACTAAGTTCGAAATAGTCTAGAGAGTACCGAAAAGGGCTAAGATAAGC
scaffold_321	reverse	GCACTAGGTTAGGTTAGGTAGTAGGTAGGTGTGGGTAGAAAATCCCTATTTTCCACCCACTACCTAGGTGGGTACCTAGTGGGTACTAAGCATAGACTAG
scaffold_394	forward	ACCCTAACCCTAACCCTAACCCTAACCCTAACCCTAACCCTAACCCTAACCCTAACCCTAACCCTAACCCTAAGACTCTAGCTAGTCGTATTACTCTTAT
scaffold_437	reverse	CGGTAATAGTATAACGCGATAAGGTCTATCGAATACGTCCTATAGATATTAGCGGCCGAACTTAATAACTTCTAGTTCTCCGCGAGTTAGTTATAGATAC
scaffold_441	reverse	AGTCTAACGGCTAGCCTAGGTTGGGTAGTGGGTACTTAGCACTAGGTTAGGTTAGGTAGTGGGTAGGTGTGGGTAGAAAATCCCTATTTTCCACCTACTA

Telomeres found: 27 (15 forward, 12 reverse)
