scaffold_29	forward	TAGGCAGTTGGAATACTTTGTTCGTGCTCATCGGTTACCACAACCAACGTCACCCTCATATTGCAGACTTAACCCTAACCCTAACCCTAAAAAAATCATG
scaffold_30	reverse	TCATCAGAGAGCTGTTTTTAGGGTTAGGGTTAGGGTTAGGGTTAAGTCTGCAATATGAGGGTGACGTTGGTTGTGGTAACCGATGAGCACGAACAAAGTA
scaffold_31	reverse	TATCGTGAAGCTTCACCATATCGGGGTTAGGGTTAGGGTTAGGGTTAAGTCTGCAATATGAGGGTGACGTTGGTTGTGGTAACCGATGAGCACGAACAAA
scaffold_34	reverse	TGCCTCTTATCAAAAGAGCGCAGGCGCCAAGCCCTGGTAAGGTCTTCTATAGCGAAGCCTACCGTATCGGGGTTTGGGTTAGAAGTTAGGGGTTAGAGTT
scaffold_37	forward	AATACTTTGTTCGTGCTCATCAATTACCACAACCAACGTCACCCTCATATTGCAGACTTAACCCTAACCCTAACCCTAAATAAGCACCTGTATATTTTCT
scaffold_39	forward	TAGGAATACTTTGTTCGTGCTCATCAATTACCACAACCAACGTCACCCTCATATTGCAGACTTAACCCTAACCCTAAGAAAAAAACAATGAGAAAGTCAA
scaffold_44	reverse	TTCAAAACAACAAAACAATTTTCTAGGGTTAGGGTTAGGGTTAAGTCTGCAATATGAGGGTGACGTTGGTTGTGGTAACCGATGAGCACGAACAAAGTAT
scaffold_45	forward	GTAGGAACACTTTGTTCGTGCTCATCAATTACCACAACCAACGTCACCCTCATATTGCAGACTTAACCCTAACCCTATTATAGAACTTAATTTCCATTAA
scaffold_46	reverse	AAGACATTCACAGAATACTCTTATGGGTTAGGGTTAGGGTTAGGGTTAGGGTTAGGGTTAGGGTTAGGGTTAGGGTTAGGGTTAGGGTTAGGGTTAGGGT
scaffold_48	forward	AGGAATACTTTGTTCGTGCTCATCAATTACCACAACCAACGTCACCCTCATATTGCAGACTTAACCCTAACCCTAACTTAACCCTAACCCTAACCCTAAC
scaffold_58	reverse	TAATAAAGTTTATAGTAACTGACTTAGGGTTAGGGTTAGGGTTAGGGTTAGGGTTAGGGTTAGGGTTAGGGTTAGGGTTAGGGTTAGGGTTAGGGTTAGG
scaffold_65	forward	TAACCCTAACCCTAACCCTAACCCTAACCCTAACCCTAACCCTAACCCTAACCCTAACCCTAACCCTAACCCTAAGTTCAGAAATTCATAGTGTTTCAAT
scaffold_66	forward	ACTTTGTTCGTGCTCATCAATTACCACAACCAACGTCACCCTCATATTGCAGACTTAACCCTAACCCTAACCCTAACTTTATTCTGACTATATTGGTATA
scaffold_68	reverse	AGCTCATTCAGCTGAGCATCTTTGGGTTAGGGTTAAGTCTGCAATATGAGGGTGACGTTGGTTGTGGTAACCGATGAGCACGAACAAAGTATTCCAACTG
scaffold_76	reverse	ACTTACCGATTGATTCCAAACCATTAGGGTTAGGGTTAGGGTTAAGTCTGCAATATGAGGGTGACGTTGGTTGTGGTAACCGATGAGCACGAACAAAGTA
scaffold_77	reverse	TAATTAGGGTTAGGGTTAAGTCTGGGTTAGGGTTAGGGTTAGGGTTAGGGTTAGGGTTAGGGTTAGGGTTAGGGTTAGGGTTAGGGTTAGGGTTAGGGTT
scaffold_86	reverse	TCGATATCGACTTGAGCTCCAATGGGTTAGGGTTAAGTCTGCAATATGAGGGTGACGTTGGTTGTGGTAATTGATGAGCACGAACAAAGTGTTCCTACTG
scaffold_87	reverse	GTAAGTGCTAATTTTGCTGAAATTTAGGGTTAGGGTTAGGGTTAAGTCTGCAATATGAGGGTGACGTTGGTTGTGGTAAATGATGAGCACGAACAAAGTG
scaffold_93	forward	TACTTTGTTCGTGCTCATCGGTTACCACAACCAACGTCACCCTCATATTGCAGACTTAACCCTAACCCTAACCCTAAGATTCTCAATTATATACTCAATT
scaffold_97	forward	ACCCTAACCCTAACCCTAACCCTAACCCTAACCCTAACCCTAACCCTAACCCTAACCCTAACCCTAACCCTAACCCAAAAATGCAGTCTTTAATTGAATT
scaffold_107	forward	CTGTAGGCAGTTGGAATACTTTGTTCGTGCTCATCGGTTACCACAACCAACGTCACCCTCATATTGCAGACCTAACCCTAACCCTAACCCTAACCCTAAT
scaffold_108	reverse	AATTGTACAATTGTTTGTAGCTATAGGGTTAGGGTTAAGTCTGCAATATGAGGGTGACGTTGGTTGTGGTAACCGATGAGCACGAACAAAGTATTCCAAC
scaffold_111	reverse	CAATTGTATAAACAACAAAGTTTGGGTTAGGGTTAGGGTTAGGGTTAAGTCTGCAATATGAGGGTGACGTTGGTTGTGGTAACCGATGAGCACGAACAAA
scaffold_128	reverse	AATGAAAAATAATGACTAAAAAATGGGTTAGGGTTAGGGTTAGGGTTAAGTCTGCAATATGAGGGTGACGTTGGTTGTGGTAACCGATGAGCACGAACAA
scaffold_136	reverse	GAAATGATTATTGAGAAGATACAGGTTAGGGTTAGGGTTAGGGTTAAGTCTGCAATATGAGGGTGACGTTGGTTGTGGTAAATGATGAGCACGAACAAAG
scaffold_228	forward	GGAATACTTTGTTCGTGCTCATCAATTACCACAACCAACGTCACCCTCATATTGCAGACTTAACCCTAACCTTTGACGTTGGAGTCATGTCTGTTCAGTC

Telomeres found: 26 (11 forward, 15 reverse)
