scaffold_38	forward	CATTTTTATAGCATAAACTTTAAAAGTGTCATATGATTTTAGTTAAGCAATCATATCACAGCAATTTGATCATGTGTTAAAATTAAAGTTATAACTAACT
scaffold_62	forward	ACCCTAACCCTAACCCTAACCCTAACCCTAACCCTAACCCTAACCCTAACCCTAACCCTAACCCTAACCCTAACCCTAACCCTAACCCTAATGCTTGAAA
scaffold_141	forward	CCTAACCCTAACCCTAACCCTAACCCTAACCCTAACCCTAACCCTAACCCTAACCCTAACCCTAACCCTAACCCTAACCCTAACCCTAACCTTAACCCTA
scaffold_151	forward	CCTAACCCTAACCCTAACCCTAACCCTAACCCTAACCCTAACCCTAACCCTAACCCTAACCCTAACCCTAACCCTAACCCTAACCCTAAGCAAGCATCCT
scaffold_177	forward	AACCCTAACCCTAACCCTAACCCTAACCCTAACCCTAACCCTAACCCTAACCCTAACCCTAACCCTAACCCTAACCCTAACCCTAACCCTGGGTCAATCC
scaffold_214	forward	AACCCTAACCCTAACCCTAACCCTAACCCTAACCCTAACCCTAACCCTAACCCTAACCCTAACCCTAACCCTAACCCTAACCCTAACCCTAGGAATGAAT
scaffold_261	forward	ACCCTAACCCTAACCCTAACCCTAACCCTAACCCTAACCCTAACCCTAACCCTAACCCTAACCCTAACCCTAACCCTAACCCTAACCCTGAGAATGAGAA
scaffold_293	reverse	ATCAGCACATAGGGTTAGGGTTAGGGTTAGGGTTAGGGTTAGGGTTAGGGTTAGGGTTAGGGTTAGGGTTAGGGTTAGGGTTAGGGTTAGGGTTAGGGTT
scaffold_307	reverse	AAAAGCTTAATGAGGGTTAGGGTTAGGGTTAGGGTTAGGGTTAGGGTTAGGGTTAGGGTTAGGGTTAGGGTTAGGGTTAGGGTTAGGGTTAGGGTTAGGG
scaffold_359	forward	ACCCTAACCCTAACCCTAACCCTAACCCTAACCCTAACCCTAACCCTAACCCTAACCCTAACCCTAACCCTAACCCTAACCCTAACCCTAAGCCTAAGCC
scaffold_368	reverse	TAGCTCAATGGTAGAGCTAAATACTGTTAATATTTAGACAGATGTTCGATTCATCTTAAAGGCTATACAGCTAGTTAGTTAATTGCTATAAGGAAAAACA
scaffold_370	reverse	TTATTTTATCTTAGGGTTAGGGTTAGGGTTAGGGTTAGGGTTAGGGTTAGGGTTAGGGTTAGGGTTAGGGTTAGGGTTAGGGTTAGGGTTAGGGTTAGGG
scaffold_429	reverse	CCGCTAGGCGAGTTAGGGTTAGGGTTAGGGTTAGGGTTAGGGTTAGGGTTAGGGTTAGGGTTAGGGTTAGGGTTAGGGTTAGGGTTAGGGTTAGGGTTAG
scaffold_440	reverse	CTTCACTGAGTTAGGGTTAGGGTTAGGGTTAGGGTTAGGGTTAGGGTTAGGGTTAGGGTTAGGGTTAGGGTTAGGGTTAGGGTTAGGGTTAGGGTTAGGG
scaffold_451	forward	TCACAGCAATTTGATCATGTGTTCAAATTAAAGTTATAACTAACTTACTACTAACTTGTTACTCAATTATCTCACAGTATATTGATCACATGATGGCCTT
scaffold_453	forward	AAACTTTAAAAGTGTCATGTGATTTTAGTTAAGCAATCATATCACAGCAATTTGATCATGTGTTCAAATTAAAGTTATAACTAACTTACTATTAACTTGT
scaffold_459	forward	CTAACCCTAACCCTAACCCTAACCCTAACCCTAACCCTAACCCTAACCCTAACCCTAACCCTAACCCTAACCCTAACCCTAACCCTAACCCGTGTGATGG
scaffold_463	reverse	CAAAATAATCACATAGGGTTAGGGTTAGGGTTAGGGTTAGGGTTAGGGTTAGGGTTAGGGTTAGGGTTAGGGTTAGGGTTAGGGTTAGGGTTAGGGTTAG
scaffold_498	forward	CCCTAACCCTAACCCTAACCCTAACCCTAACCCTAACCCTAACCCTAACCCTAACCCTAACCCTAACCCTAACCCTAACCCTAACCCTAATCCGCGTAGC
scaffold_529	forward	ACCCTAACCCTAACCCTAACCCTAACCCTAACCCTAACCCTAACCCTAACCCTAACCCTAACCCTAACCCTAACCCTAACCCTAACCCTAGCACAAGGAA

Telomeres found: 20 (13 forward, 7 reverse)
