scaffold_1	reverse	TGCAATCTCTATAGTAGTTAGTTAGTATAACTAATAAAATTTTTATTTACTTAATAGTTTTATAGGTTATAAGCCCGGCTTAACGTCTTTAGAACGTATA
scaffold_18	forward	CTAACCCTAACCCTAACCCTAACCCTAACCCTAACCCTAACCCTAACCCTAACCCTAACCCTAACCCTAACCCTAACCCTAACCCTAACTAGATATATAA
scaffold_20	reverse	ATTAGAGAAAGGGTTAGGGTTAGGGTTAGGGTTAGGGTTAGGGTTAGGGTTAGGGTTAGGGTTAGGGTTAGGGTTAGGGTTAGGGTTAGGGTTAGGGTTA
scaffold_21	reverse	CTCTAGCGAATAGGGTTAGGGTTAGGGTTAGGGTTAGGGTTAGGGTTAGGGTTAGGGTTAGGGTTAGGGTTAGGGTTAGGGTTAGGGTTAGGGTTAGGGT
scaffold_23	forward	CCCTAACCCTAACCCTAACCCTAACCCTAACCCTAACCCTAACCCTAACCCTAACCCTAACCCTAACCCTAACCCTAACCCTAACCCTATAGATATAGTG
scaffold_26	forward	CCCTAACCCTAACCCTAACCCTAACCCTAACCCTAACCCTAACCCTAACCCTAACCCTAACCCTAACCCTAACCCTAACCCTAACCCTATTTTAGCCTTA
scaffold_31	reverse	ATTAATAACTTAGGGTTAGGGTTAGGGTTAGGGTTAGGGTTAGGGTTAGGGTTAGGGTTAGGGTTAGGGTTAGGGTTAGGGTTAGGGTTAGGGTTAGGGT
scaffold_32	forward	CCCTAACCCTAACCCCTAACCCTAACCCTAACCCTAACCCTAACCCTAACCCTAACCCTAACCCTAACCCTAACCCTAACTAACCTAACCCTAACCCTAA
scaffold_34	reverse	GTTAGGGTTAAGGGTTAGGGTTAGGGTTAGGGTTAGGGTTAGGGTTAGGGTTAGGGTTAGGGTTAGGGTTAGGGTTAGGGTTAGGGTTAGGGTTAGGGTT
scaffold_43	reverse	AAGGTCTTGCGACTAGGTTTCTAATATCTTACGAATAGTATACTTTCTAATTTTTAGGATAGTTAGTTAACTCGGCTCTTTTAAGCTTAAATAAATAAAT
scaffold_60	forward	AACCCTAACCCTAACCCTAACCCTAACCCTAACCCTAACCCTAACCCTAACCCTAACCCTAACCCTAACCCTAACCCTAACCCTAACCCTACCCGCCTTA
scaffold_69	reverse	AAAATAGCTACTTAGGGTTAGGGTTAGGGTTAGGGTTAGGGTTAGGGTTAGGGTTAGGGTTAGGGTTAGGGTTAGGGTTAGGGTTAGGGTTAGGGTTAGG
scaffold_78	reverse	TTAGGGTTAGTTAGGGTTAGGGTTAGGGTTAGGGTTAGGGTTAGGGTTAGGGTTAGGGTTAGGGTTAGGGTTAGGGTTAGGGTTAGGGTTAGGGTTAGGG
scaffold_90	reverse	GTATAAGGCTTAGTTAGGGTTAGGGTTAGGGTTAGGGTTAGGGTTAGGGTTAGGGTTAGGGTTAGGGTTAGGGTTAGGGTTAGGGTTAGGGTTAGGGTTA
scaffold_96	reverse	TAAGCTTAGAGTTAGGGTTAGGGTTAGGGTTAGGGTTAGGGTTAGGGTTAGGGTTAGGGTTAGGGTTAGGGTTAGGGTTAGGGTTAGGGTTAGGGTTAGG
scaffold_116	forward	CTAACCCTAACCCTAACCCTAACCCTAACCCTAACCCTAACCCTAACCCTAACCCTAACCCTAACCCTAACCCTAACCCTAACCCTAACCCAAATCCAAA
scaffold_119	forward	ACCCTAACCCTAACCCTAACCCTAACCCTAACCCTAACCCTAACCCTAACCCTAACCCTAACCCTAACCCTAACCCTAACCCTAACCCTAATACTAATAC
scaffold_132	forward	CCTAACCCTAACCCTAACCCTAACCCTAACCCTAACCCTAACCCTAACCCTAACCCTAACCCTAACCCTAACCCTAACCCTAACCCTAATAATTATAAAT
scaffold_208	reverse	GCTATTTTAAACTTAGTTAGTTAAGATCGGAGTTAGCTTAAAATCCGGTCTAAATAGCTTCGGGGACTAAATCCGAGTTTAGAATTTTTAGAATTTTAGA
scaffold_379	forward	CCTAACCCTAACCCTAACCCTAACCCTAACCCTAACCCTAACCCTAACCCTAACCCTAACCCTAACCCTAACCCTAACCCTAACCCTATTCTCTATTATT
scaffold_380	reverse	ACTAGGTTAGGTTAGGTAGTGGGTAGGTATGGGTAGAAAATCCCTATTTTCCACCCACTACCCAGGTGGGTACCTAGTGGGTACTAAGCATAGACTAGCT
scaffold_432	reverse	CGCGATAAGGTCTATCGAATACGTCCTATAGATATTAGCGGCCGAACTTAATAACTTCTAGTTCTCCGCGAGTTAGTTATAGATACTAAACTAGCTAATA

Telomeres found: 22 (9 forward, 13 reverse)
