scaffold_10	reverse	AGGGTTAGGGTTAGGGTTAGGGTTAGGGTTAAGTCTGCAATATGAGGGTGACGTTGGTTGTGGTAATTGATGAGCACGAACAAAGTGTTCCTACTGTCTA
scaffold_18	reverse	TTCAAGTACTTAGGGTTAGGGTTAGGGTTAAGTCTGCAATATGAGGGTGACGTTGGTTGTGGTAATTGATGAGCACGAACAAAGTGTTCCTACTGTCTAC
scaffold_20	reverse	TGTGGCTTTTTAGGGTTAGGGTTAGGGTTAAGTCTGCAATATGAGGGTGACGTTGGTTGTGGTAATTGATGAGCACGAACAAAGTGTTCCTACTGTCTAC
scaffold_28	reverse	ATGCTTGTCGGTTAGGGTTAAGTCTGCAATATGAGGGTGACGTTGGTTGTGGTAATTGATGAGCACGAACAAAGTGTTCCTACTGTCTACAGTCAAGTAA
scaffold_46	reverse	CTTAACACATTAGGGTTAGGGTTAGGGTTAGGGTTAGGGTTAGGGTTAGGGTTAGGGTTAGGGTTAGGGTTAGGGTTAGGGTTAGGGTTAGGGTTAGGGT
scaffold_53	reverse	AGTAAAATATAGGGTTAGGGTTAGGGTTAAGTCTGCAATATGAGGGTGACGTTGGTTGTGGTAATTGATGAGCACGAACAAAGTGTTCCTACTGTCTACA
scaffold_62	forward	CTTACTTGACTGTAGACAGTAGGAACACTTTGTTCGTGCTCATCAATTACCACAACCAACGTCACCCTCATATTGCAGACTTAACCCTAACTGAGTTATT
scaffold_64	reverse	ATGATCAGATAGGGTTAGGGTTAGGGTTAGGGTTAGGGTTAAGTCTGCAATATGAGGGTGACGTTGGTTGTGGTAATTGATGAGCACGAACAAAGTGTTC
scaffold_74	forward	TAGACAGTAGGAACACTTTGTTCGTGCTCATCAATTACCACAACCAACGTCACCCTCATATTGCAGACTTAACCCTAACCCTAACCCTAACTTTATTCTG
scaffold_76	reverse	AAAAGGGTTAGGGTTAGGGTTAGGGTTAGGGTTAGGGTTAAGTCTGCAATATGAGGGTGACGTTGGTTGTGGTAATTGATGAGCACGAACAAAGTGTTCC
scaffold_86	reverse	AATAAATTAGGTTAGGGTTAGGGTTAGGGTTAAGTCTGCAATATGAGGGTGACGTTGGTTGTGGTAATTGATGAGCACGAACAAAGTGTTCCTACTGTCT
scaffold_93	forward	AGACAGTAGGAACACTTTGTTCGTGCTCATCAATTACCACAACCAACGTCACCCTCATATTGCAGACTTAACCCTAACCCTAACCCTAACATACAGAGTA
scaffold_95	reverse	TGTTGCTTTGGGTTAGGGTTAGGGTTAGGGTTAAGTCTGCAATATGAGGGTGACGTTGGTTGTGGTAATTGATGAGCACGAACAAAGTGTTCCTACTGTC
scaffold_96	reverse	GCATTTAAATAGGGTTAGGGTTAGGGTTAGGGTTAGGGTTAGGGTTAGGGTTAGGGTTAGGGTTAGGGTTAGGGTTAGGGTTAGGGTTAGGGTTAGGGTT
scaffold_103	reverse	TATTTCTTTCTTAGGGTTAGGGTTAGGGTTAAGTCTGCAATATGAGGGTGACGTTGGTTGTGGTAATTGATGAGCACGAACAAAGTGTTCCTACTGTCTA
scaffold_105	forward	AACACTTTGTTCGTGCTCATCAATTACCACAACCAACGTCACCCTCATATTGCAGACTTAACCCTAACCCTAACCCTAACCCTAACCCTAAAATTTGAGA
scaffold_117	reverse	CTTTGTGCAACTTAGGGTTAGGGTTAGGGTTAAGTCTGCAATATGAGGGTGACGTTGGTTGTGGTAATTGATGAGCACGAACAAAGTGTTCCTACTGTCT
scaffold_124	reverse	ATTTATAGTTTAGGGTTAGGGTTAGGGTTAGGGTTAGGGTTAGGGTTAGGGTTAGGGTTAGGGTTAGGGTTAGGGTTAGGGTTAGGGTTAGGGTTAGGGT
scaffold_141	reverse	GCAATATGAGTTAGGGTTAGGGTTAGGGTTAGGGTTAGGGTTAGGGTTAGGGTTAGGGTTAGGGTTAGGGTTAGGGTTAGGGTTAGGGTTAGGGTTAGGG
scaffold_169	reverse	TATGAAAATGGGTTAGGGTTAAGTCTGCAATATGAGGGTGACGTTGGTTGTGGTAATTGATGAGCACGAACAAAGTGTTCCTACTGTCTACAGTCAAGTA
scaffold_176	reverse	TTGAAAGACTATAGGGTTAGGGTTAGGGTTAAGTCTGCAATATGAGGGTGACGTTGGTTGTGGTAATTGATGAGCACGAACAAAGTGTTCCTACTGTCTA
scaffold_221	forward	TTACTTGACTGTAGACAGTAGGAACACTTTGTTCGTGCTCATCAATTACCACAACCAACGTCACCCTCATATTGCAGACTTAACCCTAACCTTTGACGTT
scaffold_222	forward	CCCTAACCCTAACCCTAACCCTAACCCTAACCCTAACCCTAACCCTAACCCTAACCCTAACCCTAACCCTAACCCTAACCCTAACCCTAAGTATTTATGT

Telomeres found: 23 (6 forward, 17 reverse)
