scaffold_4	forward	CCCTAACCCTAACCCTAACCCTAACCCTTAACCCTAACCCTAACCCTAACCCTAACCCTAACCCTATGTCTCTCAAAGTATGTGAAATAGTCAGCGCGCA
scaffold_14	reverse	ATTATTAGGGTTAGGGTTAGGGTTAGGGTTAGGGTTAGGGTTAGGGTTAGGGTTAGGGTTAGGGTTAGGGTTAGGGTTAGGGTTAGGGTTAGGGTTAGGG
scaffold_22	forward	CCCTCCTTTCCCCTCTCCTTCTCTTCCTTCCTCCCTCCCTTCCCAACTAACTAACTACATATCAGCATTGCAAAATTCGCTGATGCGGGGGAGTTTGGGA
scaffold_63	reverse	TGATATGTAATTAGGGTTAGGGTTAGGGTTAGGGTTAGGGTTAGGGTTAGGGTTAGGGTTAGGGTTAGGGTTAGGGTTAGGGTTAGGGTTAGGGTTAGGG
scaffold_91	forward	CCCTAACCCTAACCCTAACCCTAACCCTAACCCTAACCCTAACCCTAACCCTAACCCTAACCCTAACCCTAACCCTAACCCTAACCCTGAGTAGGATGAA
scaffold_143	reverse	CTAGAAAGGTTAGTTACAGATAGTATCCCGGGGCACCAGATAGTATCCCGGGGTTTAGCGTGCCCCGGGATACTATCTGTAACTAACCTTTCTAGTTAGA
scaffold_148	reverse	TTAGGGTTAGGGTTAGGGTTAGGGTTAGGGTTAGGGTTAGGGTTAGGGTTAGGGTTAGGGTTAGGGTTAGGGTTAGGGTTAGGGTTAGGGTTAGGGTTAG
scaffold_194	forward	CCCTAACCCTAACCCTAACCCTAACCCTAACCCTAACCCTAACCCTAACCCTAACCCTAACCCTAACCCTAACCCTAACCCTAACCCTAACCCTAACCCT
scaffold_204	reverse	AAGTTTCAACTTTGATTTAGGGTTAGGGTTAGGGTTAGGGTTAGGGTTAGGGTTAGGGTTAGGGTTAGGGTTAGGGTTAGGGTTAGGGTTAGGGCTGTCT
scaffold_234	reverse	AATTGAAATTTCCTTTGCTTAGAAAGGGTTAGGGTTAGGGTTAGGGTTAGGGTTAGGGTTAGGGTTAGGGTTAGGGTTAGGGTTAGGGTTAGGGTTAGGG
scaffold_304	forward	ACCCTAACCCTAACCCTAACCCTAACCCTAACCCTAACCCTAACCCTAACCCTAACCCTAACCCTAATTGTTATTAACAGTTTTTCTTTATTTGCAATTT
scaffold_307	forward	CCCTAACCCTAACCCTAACCCTAACCCTAACCCTAACCCTAACCCTAACCCTAACCCTAACCCTAACCCTAACCCTAACCCTAACCCTCTACAATCTTCG
scaffold_335	forward	CTCCTTCCCTCCTCCCTCACCACGACCCATCCATACCTTACCTTACAAATCCTACCTACATAACCTAACCTAGCCCAGCCCTACCCTCCAGGCACCTCCG
scaffold_345	reverse	ATAAAAATCAACTTAAGAAAGATTGAGGTTAGGGTTAGGGTTAGGGTTAGGGTTAGGGTTAGGGTTAGGGTTAGGGTTAGGGTTAGGGTTAGGGTTAGGG
scaffold_369	forward	TATCCCGGGGTTTAGCGTGCCCCGGGATACTATCTGTAACTAACCTTTCTAGTTAGAGTGCGCGGAAACCCAGTGTGCGCGGAAACCCCGTGCATACGAG
scaffold_370	forward	ACTATCTGGTGCCCCGGGATACTATCTGTAACTAACCTTTCTAGTTAGAGTGCGCGGAAACCCAGTGTGCGCGGAAACCCCGTGCATACGAGTACTTGTT
scaffold_436	reverse	GTTCATTCAGCATATTGATAAGTTAGGGTTAGGGTTAGGGTTAGGGTTAGGGTTAGGGTTAGGGTTAGGGTTAGGGTTAGGGTTAGGGTTAGGGTTAGGG
scaffold_476	reverse	TGACGCAGGGTTAGGGTTAGGGTTAGGGTTAGGGTTAGGGTTAGGGTTAGGGTTAGGGTTAGGGTTAGGGTTAGGGTTAGGGTTAGGGTTAGGGTTAGGG
scaffold_489	reverse	ATGTTTCCAGAAATTCTTAGGGTTAGGGTTAGGGTTAGGGTTAGGGTTAGGGTTAGGGTTAGGGTTAGGGTTAGGGTTAGGGTTAGGGTTAGGGTTAGGG
scaffold_519	reverse	ATGATAAACTGATTGAAAAATTTAGGGTTAGGGTTAGGGTTAGGGTTAGGGTTAGGGTTAGGGTTAGGGTTTAGGGTTAGGGTTAGGGTTAGGGTTGGGG
scaffold_557	reverse	CATCTGTAATTGATGATTGATTGCAAACTGAGCATTAGGGTTAGGGTTAGGGTTAGGGTTAGGGTTAGGGTTAGGGTTAGGGTTAGGGTTAGGGTTAGGG
scaffold_620	forward	AACCCTAACCCTAACCCTAACCCTAACCCTAACCCTAACCCTAACCCTAACCCTTTTTATTATACTTTACTTTATAACTTTACATTACTATTACACTTCA
scaffold_644	reverse	TGCATTTAACTTAGGGTTAGGGTTAGGGTTAGGGTTAGGGTTAGGGTTAGGGTTAGGGTTAGGGTTAGGGTTAGGGTTAGGGTTAGGGTTAGGGTTAGGG
scaffold_648	forward	ACCCTAACCCTAACCCTAACCCTAACCCTAACCCTAACCCTAACCCTAACCCTAACCCTAACCCTAACCCTAACCCTAACCCTAACCCTAACCCTAACCC
scaffold_657	reverse	GTTAGGGTTAGGGTTAGGGTTAGGGTTAGGGTTAGGGTTAGGGTTAGGGTTAGGGTTAGGGTTAGGGTTAGGGTTAGGGTTAGGGTTAGGGTTAGGGTTA
scaffold_744	forward	CCCTAACCCTAACCCTAACCCTAACCCTAACCCTAACCCTAACCCTAACCCTAACCCTAACCCTAACCCTAACCCTAACCCTAACCCTATGCAATTTTGA
scaffold_756	reverse	CTTTGAAATCAATGTATGTAACTGTAATTAGGGTTAGGGTTAGGGTTAGGGTTAGGGTTAGGGTTAGGGTTAGGGTTAGGGTTAGGGTTAAGGGTTAGGG
scaffold_789	forward	CCCTAACCCTAACCCTAACCCTAACCCTAACCCTAACCCTAACCCTAACCCTAACCCTAACCTTGTTCAGTCTTATCAGTCATAATATGCTCATAACAGT
scaffold_822	forward	CCCTAACCCTAACCCTAACCCTAACCCTAACCCTAACCCTAACCCTAACCCTAACCCTAACCCTAACCCTAACCCTAACCCTAACCCTAACCCTAACCCT
scaffold_839	forward	CCCTAACCCTAACCCTAACCCTAACCCTAACCCTAACCCTAACCCTAACCCTAACCCTAACCCTAACCCTAACCCTAACATTTGAATTGCATCAAATTGA
scaffold_853	forward	CCCTAACCCTAACCCTAACCCTAACCCTAACCCTAACCCTAACCCTAACCCTAACCCTAACCCTAACCCTAACCCTAACCCTAACCCTAACCCTAAGATG
scaffold_866	reverse	TTTCTGAATTCAAAATCAATTATTAAGCTCATTTTACTTGATTTCTTAGGGTTAGGGTTAGGGTTAGGGTTAGGGTTAGGGTTAGGGTTAGGGTTTAGGG
scaffold_883	reverse	GAGTTGAATCAAAAATTTGAAGTCGATATTCAGGGTTAGGGTTAGGGTTAGGGTTAGGGTTAGGGTTAGGGCTGTCTCTGAGACAAATCTCCGACACCAA
scaffold_936	forward	AACCCTAACCCTAACCCTAACCCTAACCCTAACCCTAACCCTAACCCTACATTATACTTTACTTCACTACTTTACTTTACTTTCTTATTTTATACTATAT
scaffold_1001	reverse	GGTGGGTCAGAACAATAGGGGGCTTTGTTGACATTGTTTCTATTTACAAAAAATAACCTTTTTGACGGAACCTTACCGAATCTGGTTAGGGTTAACCTTA
scaffold_1063	forward	GTCATTAGCTGAATTTATCATCAACAATCACTTCTTTGAAAGCACTTAATGCACATCATTCTAACTAACTTCAAACAGCATTCATGAATGAGATTGAAAT
scaffold_1089	reverse	CAAGTTAGGGTTAGGGTTAGGGTTAGGGTTAGGGTTAGGGTTAGGGTTAGGGTTAGGGTTAGGGTTAGGGTTAGGGTTAGGGTTAGGGTTAGGGTTAGGG
scaffold_1110	reverse	TAATAATTAGTAAGTAATGTAGTTAGGGTTAGGGTTAGGGTTAGGGTTAGGGTTAGGGTTAGGGTTAGGGTTAGGGTTAGGGTTAGGGTTAGGGTTAGGG
scaffold_1202	forward	GTATCCCGGGGTTTAGCGTGCCCCGGGATACTATCTGTAACTAACCTTTCTAGTTAGAGTGCGCGGAAACCCAGTGTGCGCGGAAACCCCGTGCATACGA
scaffold_1291	forward	CCCTAACCCTAACCCTAACCCTAACCCTAACCCTAACCCTAACCCTAACCCTAACCCTAACCCTAACCCTAAGGGTGTACGGGTAGCGGTTCCCTTTTTT
scaffold_1454	forward	ATCTTTCATAAAGTGACTGTTATCACTCAATCAATTGATCATTTAAAGTCTGATCATCTAAAGTTGCATGACGCGATTTTAACTAACGTCAAAGAAGCAA
scaffold_1774	forward	CCCTAACCCTAACCTTGAGTCACTGTTGTATCTGATAAATATGCTGCTACTTCATTGTCAGTAATGATGACTTTGATAATCAATTATATTAAGTTTATCT
scaffold_1892	forward	CCCTAACCCTAACCCTAACCCTAACCCTATCAATATCTGATTCTTCGCTGTTTACTGATGAAAAGAACTTTATTTAAGAAAACTGATATGAAAAAATTCA
scaffold_2267	forward	GACAATAACAGCAAAGATCTTGATGTCTGATCATTTAACTAACATTCTATATGTTGCTGCTTCTATCATTGCTATGTTCATTGAACTGAAAGAGAATGAA

Telomeres found: 44 (24 forward, 20 reverse)
