scaffold_44	forward	CCTCCTTTCCCCCCTCCCTCCTTTCCCCTCTCCTTCTCTTCCTTCCTCCCTCCCTTCCCAACTAACTAACTACATATCAGCATTGCAAAATTCGCTGATG
scaffold_59	reverse	CCCCAAAAAAAAAAAGAAAAAAAAAAGAAAGAAAAAAAAAATAAAATAATAGATAAAAATCGAATATGTGGTAGGGGGGGGGGGGGTTTCATGTTAGTTA
scaffold_94	forward	GATACTATCTGTAACTAACCTTTCTAGTTAGAGTGCGCGGAAACCCAGTGTGCGCGGAAACCCCGTGCATACGAGTAACAGGTGTTATGCATCTGCGTTG
scaffold_112	forward	TAACCCTAACCCTAACCCTAACCCTAACCCTAACCCTAACCCTAACCCTAACCCTAACCCTAACCCTAACCCTGAGTAGGATGAAGAGTAAATGAGTGAG
scaffold_137	reverse	ACAAAGTTCGTATCTGGGGAACTAACTACTCGTATGCACGGGGTTTCCGCGCACACTGGGTTTCCGCGCACTCTAACTAGAAAGGTTAGTTACAGATAGT
scaffold_145	reverse	AATTATCGAATCGGCATCAACAAGTACTCGTATGCACGGGGTTTCCGCGCACACTGGGTTTCCGCGCACTCTAACTAGAAAGGTTAGTTACAGATAGTAT
scaffold_171	forward	CCCTAACCCTAACCCTAACCCTAACCCTAACCCTAACCCTAACCCTAACCCTAACCCTAACCCTAACCCTAACCCTAACCCTAAGCGATCTTGCCGACAA
scaffold_268	forward	ACCCTAACCCTAACCCTAACCCTAACCCTAACCCTAACCCTAACCCTAACCCTAACCCTAACCCTAATTGTTATTAACAGTTTTTCTTTATTTGCAATTT
scaffold_308	reverse	GTCAAAATAAAAATCAACTTAAGAAAGATTGAGGTTAGGGTTAGGGTTAGGGTTAGGGTTAGGGTTAGGGTTAGGGTTAGGGTTAGGGTTAGGGTTAGGG
scaffold_318	reverse	CGCGGACCAAACGGTTGCTCTGTCTACTCGTATGCACGGGGTTTCCGCGCACACTGGGTTTCCGCGCACTCTAACTAGAAAGGTTAGTTACAGATAGTAT
scaffold_358	forward	TAACCCTAACCCTAACCCTAACCCTAACCCTAACCCTAACCCTAACCCTAACCCTAACCCTAACCCTAACCCTGAGTGCTGAGCAATGCATATGCATATT
scaffold_364	forward	CTAACCCTAACCCTAACCCTAACCCTAACCCTAACCCTAACCCTAACCCTAACCCTAACCCTAACCCTAACCCTAAGTTAAATGCAAAAACAAGATATTA
scaffold_402	reverse	TCATGTGCATGTTTCCAGAAATTCTTAGGGTTAGGGTTAGGGTTAGGGTTAGGGTTAGGGTTAGGGTTAGGGTTAGGGTTAGGGTTAGGGTTAGGGTTAG
scaffold_438	forward	CCCTAACCCTTAACCCTAACCCTAACCCTAACCCTAACCCTAACCCTAACCCTAACCCTAACCCTAACCCTAATTACAGTTACATACATTGATTTCAAAG
scaffold_542	reverse	CAAGATTCATGATAAACTGATTGAAAAATTTAGGGTTAGGGTTAGGGTTAGGGTTAGGGTTAGGGTTAGGGTTAGGGTTAGGGTTAGGGTTAGGGTTAGG
scaffold_573	forward	ACCCTAACCCTAACCCTAACCCTAACCCTAACCCTAACCCTAACCCTAACCCTAACCCTAACCCTAACCCTAACCCTGAATGACAACTAGACTGCTTAAT
scaffold_640	reverse	CAAAGTTCATTCAGCATATTGATAAGTTAGGGTTAGGGTTAGGGTTAGGGTTAGGGTTAGGGTTAGGGTTAGGGTTAGGGTTAGGGTTAGGGTTAGGGTT
scaffold_644	forward	CCTAACCCTAACCCTAACCCTAACCCTAACCCTAACCCTAACCCTAACCCTAACCCTAACCCTAACCCTAACCCTATGCAATTTTGACTCATCAAAATTT
scaffold_711	forward	TAACCCTAACCCTAACCCTAACCCTAACCCTAACCCTAACCCTAACCCTAACCCTAACCCTAACCCTAACCCTAACCTTGTTCAGTCTTATCAGTCATAA
scaffold_718	reverse	TACAAGCATAATTATAACTAAAGCCAACACTAAAACTAATGATTTTATTTAAAACACCTGTTTTCGTAGATTTTTTAATACAAGTTGTTAGTTATGTTTT
scaffold_738	forward	CCCTAACCCTAACCCTAACCCTAACCCTAACCCTAACCCTAACCCTAACCCTAACCCTAACCCTAACCCTAACCCTAACCCTAACCCTAATGCTCAGTTT
scaffold_789	forward	ACCCTAACCCTAACCCTAACCCTAACCCTAACCCTAACCCTAACCCTAACCCTAACCCTAACCCTACATTATACTTTACTTCACTACTTTACTTTACTTT
scaffold_793	reverse	TTATTAAGCTCATTTTACTTGATTTCTTAGGGTTAGGGTTAGGGTTAGGGTTAGGGTTAGGGTTAGGGTTAGGGTTAGGGTTAGGGTTAGGGTTAGGGTT
scaffold_803	reverse	TGTTGATTGACTTAAGTGAATTATTAGGGTTAGGGTTAGGGTTAGGGTTAGGGTTAGGGTTAGGGTTAGGGTTAGGGTTAGGGTTAGGGTTAGGGTTAGG
scaffold_817	reverse	TTTCAATTTGATGCAATTCAAATGTTAGGGTTAGGGTTAGGGTTAGGGTTAGGGTTAGGGTTAGGGTTAGGGTTAGGGTTAGGGTTAGGGTTAGGGTTAG
scaffold_826	forward	CTAACCCTAACCCTAACCCTAACCCTAACCCTAACCCTAACCCTAACCCTAACCCTAACCCTAACCCTAACCCTAATTACATATCATCAATTCAACAGAG
scaffold_958	reverse	ATACTTTGAAAGACATAATTGTAGTTAGGGTTAGGGTTAGGGTTAGGGTTAGGGTTAGGGTTAGGGTTAGGGTTAGGGTTAGGGTTAGGGTTAGGGTTAG
scaffold_1043	forward	CCCTAACCCTAACCCTAACCCTAACCCTAACCCTAACCCTAACCCTAACCCTAACCCTAACCCTAACCCTAACCCCTTTCAAAGTATGTTGAGTAGTCAA
scaffold_1066	forward	CTATCTTTCTTTCTTAGCATTTATCTTCTAGTTAAATGACACTCATATTGACTCGCTCTATGCTGATCTCTAACAAGATTGTTTAACTAACTTTAATTAA
scaffold_1104	reverse	ACGTTAGTTAAAGCTGCATCACACGATTTTAACTGTTCAATTAGTTTAACTGACTTCTCATTGAACTGACTGAAAGAGAGTGATTTCAGACTGAGTTGAA
scaffold_1106	forward	ACCCTAACCCTAACCCTAACCCTAACCCTAACCCTAACCCTAACCCTAACCCTAACCCTAACCCTAACCCTAACCCTTTTTATTATACTTTACTTTATAA
scaffold_1179	forward	CCCTAACCCTAACCCTAACCCTAAAGATGATACATCAGTTTCAATGCTATTTCTTTTTACAAGTAATCTTTGCTCATTTTTTTCTTTAACATTGATGTCT
scaffold_1198	reverse	TGACGAGTTAAGTTCAAAATTTCAAGTTAGGGTTAGGGTTAGGGTTAGGGTTAGGGTTAGGGTTAGGGTTAGGGTTAGGGTTAGGGTTAGGGTTAGGGTT
scaffold_1205	reverse	CCAATCGAATAGGCTATCTTGACGTACTCGTATGCACGGGGTTTCCGCGCACACTGGGTTTCCGCGCACTCTAACTAGAAAGGTTAGTTACAGATAGTAT
scaffold_1241	reverse	ATAATGTAATAATTAGTAAGTAATGTAGTTAGGGTTAGGGTTAGGGTTAGGGTTAGGGTTAGGGTTAGGGTTAGGGTTAGGGTTAGGGTTAGGGTTAGGG
scaffold_1246	reverse	TTGGCTCAATCGAAGCGATAATCGTTACTCGTATGCACGGGGTTTCCGCGCACACTGGGTTTCCGCGCACTCTAACTAGAAAGGTTAGTTACAGATAGTA
scaffold_1260	reverse	TTTCTTCAACTTCGTTTTATACATCTTAGGGTTAGGGTTAGGGTTAGGGTTAGGGTTAGGGTTAGGGTTAGGGTTAGGGTTAGGGTTAGGGTTAGGGTTA
scaffold_1319	forward	CAGTCAGTTCAATGAGAAGTCAGTTAAACTAATTGAACAGTTAAAATCGCGTGACGCGACTTTAACTAACGTCAAAATTTCTAAATTAACATTAAATTCA
scaffold_1433	reverse	TCAAGGGCTTAAGTGCTTTTATGATACTCGTATGCACGGGGTTTCCGCGCACACTGGGTTTCCGCGCACTCTAACTAGAAAGGTTAGTTACAGATAGTAT
scaffold_1446	reverse	TGATAGAAAGTTTCAACTTTGATTTAGGGTTAGGGTTAGGGTTAGGGTTAGGGTTAGGGTTAGGGTTAGGGTTAGGGTTAGGGTTAGGGTTAGGGTTAGG
scaffold_1676	forward	AAAGTCGCGCGACGCGATTTTAACTAACGTCAAAGAAGCAGACATTCTAGTCGAAAGCTGTTTTGTATGTCATAAATCAGGTCATAGCTCTAAGAAGTGT
scaffold_1678	forward	CCCTAACCCTAACCCTAACCCTAACCCTAACCCTAACCCTAACCCTAACCCTAACCCTAACCCTAACCCTAAGGGTGTACGGGTAGCGGTTCCCTTTTTT
scaffold_1680	forward	ACCCTAACCCTAACCCTAACCCTAACCCTAACCCTAACCCTAACCCTAACCCTAACCCTAACCCTAACCCTAAGAATAAGAATAAGAATAAGAATAAGAA
scaffold_1697	reverse	GTTTAAAATGTTGATTTTCAAGTTTTCAAATCTCTTAGTCTTAGTCTTAGTCTTAGTCTTAGTCTTAGTCTTAGGGTTAGGGTTAGGGTTAGGGTTAGGG
scaffold_1731	forward	CCCTAACCCTAACCCTAACCCTAACCCTAACCCTAACCCTAACCCTTGAGATTTATGAACTTTTTGATAAGCTGATTCAACAGTATTCTTGAACTTAGAA
scaffold_1854	forward	GTCAGTTAAACTAATTGAACAGTTAAAATCGCGTGACGCGACTTTAACTAACGTCAAAAATTCTAAATCGACGTTCAGTCTGAATTCATTCTCTTTCAGT
scaffold_1895	forward	ATCGCGTGACGCGACTTTAACTAACGTCAAAAATTCTAAATCAACGTTCAGTCTGAATTCATTCTCTTTCAGTTCAACGAACATAGCAATGATAGAGACA
scaffold_2043	reverse	TCAGTTTTGTCAGATCTATTTGAATGACATTATAGGGTTAGGGTTAGGGTTAGGGTTAGGGTTAGGGTTAGGGTTAGGGTTAGGGTTAGGGTTAGGGTTA
scaffold_2578	forward	AAATCATATGACGTGATTTTAACTAACGTCAAAGACATTGATTTACAAGCTGAAATCTGTTTCATCTGTCACAAATCAGATTATACTTCTAGAGAGTACT
scaffold_2589	reverse	TGTTATCTTTTTATTAATATCACTTTACTGACTTCCATTTCTAGGGTTAGGGTTAGGGTTAGGGTTAGGGTTAGGGTTAGGGTTAGGGTTAGGGTTAGGG

Telomeres found: 50 (26 forward, 24 reverse)
