scaffold_30	forward	CTAACCCTAACCCTAACCCTAACCCTAACCCTAACCCTAACCCTAACCCTAACCCTAACCCTAACCCTAACCCTAACAAATATCCCCACAGCATGAAGAC
scaffold_34	forward	CCTAACCCTAACCCTAACCCTAACCCTAACCCTAACCCTAACCCTAACCCTAACCCTAACCCTAACCCTAACCCTAAGCTGTGCATTGAGACCACAAATG
scaffold_38	forward	CCTAACCCTAACCCTAACCCTAACCCTAACCCTAACCCTAACCCTAACCCTAACCCTAACCCTAACCCTAACCCTAAATCCGATCATCTGCCCACTCGTA
scaffold_40	forward	TAACCCTAACCCTAACCCTAACCCTAACCCTAACCCTAACCCTAACCCTAACCCTAACCCTAACCCTAACCCTAACCTCTAAACCCCAGTACGGTGAAGC
scaffold_45	forward	AACCCTAACCCTAACCCTAACCCTAACCCTAACCCTAACCCTAACCCTAACCCTAACCCTAACCCTAACCCTAACCCGAGCAGTATTTTGTGGATACTAG
scaffold_47	reverse	TATAGCGAAGCTTCACCGTACCAGGGTTAGGGTTAGGGTTAGGGTTAGGGTTAGGGTTAGGGTTAGGGTTAGGGTTAGGGTTAGGGTTAGGGTTAGGGTT
scaffold_48	reverse	TTGCAACTGAAAAGAGAGAGAACCTTAGGGTTAGGGTTAGGGTTAGGGTTAGGGTTAGGGTTAGGGTTAGGGTTAGGGTTAGGGTTAGGGTTAGGGTTAG
scaffold_60	forward	TAACCCTAACCCTAACCCTAACCCTAACCCTAACCCTAACCCTAACCCTAACCCTAACCCCGGTACGGTGAAGCTTCACTATAGAAGACCTCACCAGGGC
scaffold_62	reverse	TAACACTTTTCATTAAAGACTTAAGGGTTAGGGTTAGGGTTAGGGTTAGGGTTAGGGTTAGGGTTAGGGTTAGGGTTAGGGTTAGGGTTAGGGTTAGGGT
scaffold_65	forward	CCTAACCCTAACCCTAACCCTAACCCTAACCCTAACCCTAACCCTAACCCTAACCCTAACCCTAACCCTAACCCTATCTGATCATTCATACACAAAACTT
scaffold_80	reverse	TATACCAACATAGTCAGAATAAAGTTAGGGTTAGGGTTAGGGTTAGGGTTAGGGTTAGGGTTAGGGTTAGGGTTAGGGTTAGGGTTAGGGTTAGGGTTAG
scaffold_82	forward	CTAACCCTAACCCTAACCCTAACCCTAACCCTAACCCTAACCCTAACCCTAACCCTAACCCTAACCCTAACCCTAATGCTCTTTTTAAAAAAAACTCTTA
scaffold_94	reverse	TCAAAATTTGACAGAATGAAAAAATTAGGGTTAGGGTTAGGGTTAGGGTTAGGGTTAGGGTTAGGGTTAGGGTTAGGGTTAGGGTTAGGGTTAGGGTTAG
scaffold_95	forward	ACCCTAACCCTAACCCTAACCCTAACCCTAACCCTAACCCTAACCCTAACCCTAACCCTAACCCTAACCCTAACCCTGACTGATTTTAAAACATTTTTAA
scaffold_97	reverse	TCGCGTTCGAAGTAGCTGGCCGCAGTTAGGGTTAGGGTTAGGGTTAGGGTTAGGGTTAGGGTTAGGGTTAGGGTTAGGGTTAGGGTTAGGGTTAGGGTTA
scaffold_100	forward	CTAACCCTAACCCTAACCCTAACCCTAACCCTAACCCTAACCCTAACCCTAACCCTAACCCTAACCCTAACCCTAAACAGTACAACAGTGAAGAATTAAT
scaffold_106	forward	CTAACCCTAACCCTAACCCTAACCCTAACCCTAACCCTAACCCTAACCCTAACCCTAACCCTAACCCTAACCCTAAGAAATACAATTTAAAACTGAAAAT
scaffold_110	forward	CCTAACCCTAACCCTAACCCTAACCCTAACCCTAACCCTAACCCTAACCCTAACCCTAACCCTAACCCTAACCCTAATATAGAACTTAATTTCCATTAAC
scaffold_115	reverse	GGGCCGAGTTTGGAAACCCTCTTCAGCTTAGGGTTAGGGTTAGGGTTAGGGTTAGGGTTAGGGTTAGGGTTAGGGTTAGGGTTAGGGTTAGGGTTAGGGT
scaffold_116	forward	AACCCTAACCCTAACCCTAACCCTAACCCTAACCCTAACCCTAACCCTAACCCTAACCCTAACCCTAACCCTAATTTATCAAACTTTTCACACACTGTTT
scaffold_125	reverse	CTCTTATTGGAAGAGTGCAGGCACCAAGCCCTGGTGAGGTCTTCTATAGTGAAGCTTCACCGTACCGGGGTTAGGGTTAGGGTTAGGGTTAGGGTTAGGG
scaffold_126	forward	TAACCCTAACCCTAACCCTAACCCTAACCCTAACCCTAACCCTAACCCTAACCCTAACCCTAACCCTAACCCTAAGACCTCACCAAGGCTTGGCGCCTGC
scaffold_158	reverse	GTGAAATGATTATTGAGAAGATACGGGTTAGGGTTAGGGTTAGGGTTAGGGTTAGGGTTAGGGTTAGGGTTAGGGTTAGGGTTAGGGTTAGGGTTAGGGT
scaffold_159	reverse	GATGATTGCAATTTTTCACTCAATAGGGTTAGGGTTAGGGTTAGGGTTAGGGTTAGGGTTAGGGTTAGGGTTAGGGTTAGGGTTAGGGTTAGGGTTAGGG
scaffold_206	forward	CCCTAACCCTAACCCTAACCCTAACCCTAACCCTAACCCTAACCCTAACCCTAACCCTAACCCTAACCTCTAAACCCAAACCCCAGTACGGTGAAGCTTC

Telomeres found: 25 (15 forward, 10 reverse)
