scaffold_89	forward	CCCTAACCCTAACCCTAACCCTAACCCTAACCCTAACCCTAACCCTAACCCTAACCCTAACCCTAACCCTAAGAAATTCTTTGAATTACTTTCATCAAAA
scaffold_94	forward	CCCTAACCCTAACCCTAACCCTAACCCTAACCCTAACCCTAACCCTAACCCTAACCCTAACCCTAACCCTAACCCTAACCCTAACCCTAATAAATGTTAT
scaffold_96	reverse	ATAGATAGGGTTAGGGTTAGGGTTAGGGTTAGGGTTAGGGTTAGGGTTAGGGTTAGGGTTAGGGTTAGGGTTAGGGTTAGGGTTAGGGTTAGGGTTAGGG
scaffold_105	reverse	ACTACAAATAGTCCACTTACTCGTATGCACGGGGTTTCCGCGCACACTGGGTTTCCGCGCACTCTAACTAGAAAGGTTAGTTACAGATAGTATCCCGGGG
scaffold_114	forward	CCCTAACCCTAACCCTAACCCTAACCCTAACCCTAACCCTAACCCTAACCCTAACCCTAACCCTAACCCTAACCCTAACCCACAAATTTATTCTTTTCAA
scaffold_121	forward	ACCCTAACCCTAACCCTAACCCTAACCCTAACCCTAACCCTAACCCTAACCCTAACCCTAACCCTAACCCTAACCCTAACCCTAACCCTAACCCTAAATT
scaffold_135	reverse	CGATTGGAACGTGGGCGGGGTTAGGGTTTGGGTTAGGGTTAGGGTTAGGGTTAGGGTTAGGGTTAGGGTTAGGGTTAGGGTTAGGGTTAGGGTTAGGGTT
scaffold_172	forward	CCCTAACCCTAACCCTAACCCTAACCCTAACCCTAACCCTAACCCTAACCCTAACCCTAACCCTAACCCTAACCCTAACCCTAAACCTAACCCTAACCCT
scaffold_188	reverse	TCATTGAAGAAATTGATAGATAACATCAGAACATCATTACACTTCATGGGTTTGCTGAAAAATTGTTAGTTACAAAGTAAATTGAAAAACAAGAAAGAAC
scaffold_211	forward	CCCTAACCCTAACCCTAACCCTAACCCTAACCCTAACCCTAACCCTAACCCTAACCCTAACCCTAACCCTAACCCTAACCCTAACCCTGATTAAAAAGCG
scaffold_226	reverse	AAAAGATGAGATTAACTCAAGATTCAAGAAAACATTAGGGTTAGGGTTAGGGTTAGGGTTAGGGTTAGGGTTAGGGTTAGGGTTAGGGTTAGGGTTAGGG
scaffold_252	forward	CCCTAACCCTAACCCTAACCCTAACCCTAACCCTAACCCTAACCCTAACCCTAACCCTAACCCTAAGTTCGCTCTGTGGTCGTGACCTGGCGGTAGACTG
scaffold_266	forward	CCCTAACCCTAACCCTAACCCTAACCCTAACCCTAACCCTAACCCTAACCCTAACCCTAACCCTAACCCTAACCCTAACCCCTAAGTGAAAGCTTTCTGC
scaffold_274	forward	CCTAACCCTAACCCTAACCCTAACCCTAACCCTAACCCTAACCCTAACCCTAACCCTAACCCTAACCCTAACCCTAACCCTAACCCTAACCCTAACCCTA
scaffold_279	forward	AACCCTAACCCTAACCCTAACCCTAACCCTAACCCTAACCCTAACCCTAACCCTAACCCTAACCCTAACCCTAACCCTAACCCTAACCCTAACCCTAACC
scaffold_291	reverse	ATTTCGCTGCATAATTTTAGGGTTAGGGTTAGGGTTAGGGTTAGGGTTAGGGTTAGGGTTAGGGTTAGGGTTAGGGTTAGGGTTAGGGTTAGGGTTAGGG
scaffold_427	reverse	AGGCGGCAATACGTTGAGTGAACAAGGGTTAGGGTTAGGGTTAGGGTTAGGGTTAGGGTTAGGGTTAGGGTTAGGGTTAGGGTTAGGGTTAGGGTTAGGG
scaffold_444	reverse	AGCTTAGGGTTAGGGTTAGGGTTAGGGTTAGGGTTAGGGTTAGGGTTAGGGTTAGGGTTAGGGTTAGGGTTAGGGTTAGGGTTAGGGTTAGGGTTAGGGT
scaffold_457	reverse	CTCGACGTGCGACGATAACCGCTAACCGCTAAGTATATAATTAGGGTTAGGGTTAGGGTTAGGGTTAGGGTTAGGGTTAGGGTTAGGGTTAGGGTTAGGG
scaffold_513	reverse	AAGAAGAAATTTAGGGTTAGGGTTAGGGTTAGGGTTAGGGTTAGGGTTAGGGTTAGGGTTAGGGTTAGGGTTAGGGTTAGGGTTAGGGTTAGGGTTAGGG
scaffold_514	reverse	GAAAATGTTGCCGTGATTTTTATCTTGGATTGAGGAAGGTAAGGTAGTTAGGTTATGTTGGATGTGGGGGGTGGGCTTGGCGGAATTTGGGGGGTGTGGG
scaffold_520	reverse	TATTTACTGCATTTGCTTACTGCATAAATTAGGGTTAGGGTTAGGGTTAGGGTTAGGGTTAGGGTTAGGGTTAGGGTTAGGGTTAGGGTTAGGGTTAGGG
scaffold_543	forward	CCCTAACCCTAACCCTAACCCTAACCCTAACCCTAACCCTAACCCTAACCCTAACCCTAACCCTAACCCTAACCCTAACCCTAACCCTAACCCTAACCCT
scaffold_548	forward	CCCTAACCCTAACCCTAACCCTAACCCTAACCCTAACCCTAACCCTAACCCTAACCCTAACCCTAACCCTAAGCATGAAAATCAATCTAGCTTTGTGATG
scaffold_554	reverse	CAAGTTTTGGTTAGGGTTAGGGTTAGGGTTAGGGTTAGGGTTAGGGTTAGGGTTAGGGTTAGGGTTAGGGTTAGGGTTAGGGTTAGGGTTAGGGTTAGGG
scaffold_571	forward	CCCTAACCCTAACCCTAACCCTAACCCTAACCCTAACCCTAACCCTAACCCTAACCCTAACCCTAACCCTAACCCTAACCCTAACCCTAACCCAGTCATT
scaffold_644	forward	CCCTAACCCTAACCCTAACCCTAACCCTAACCCTAACCCTAACCCTAACCCTAACCCTAACCCTAACCCTAACCCTGAGATTTCAACTAGATTTCGTGAA
scaffold_644	reverse	CTCGTATGCACGGGGTTTCCGCGCACACTGGGTTTCCGCGCACTCTAACTAGAAAGGTTAGTTACAGATAGTATCCCGGGGTTTAGCGTGCCCCGGGATA
scaffold_714	reverse	CAATAATCATTTGATTGAGAAAGTGATAATTGATTAGGGTTAGGGTTAGGGTTAGGGTTAGGGTTAGGGTTAGGGTTAGGGTTAGGGTTAGGGTTAGGGT
scaffold_787	forward	AACCCTAACCCTAACCCTAACCCTAACCCTAACCCTAACCCTAACCCTAACCCTAACCCTAACCCTAACCCTAACCCTAACCCTAACCCTTCATGTAAGA
scaffold_887	forward	CCCTAACCCTAACCCTAACCCTAACCCTAACCCTAACCCTAACCCTAACCCTAACCCTAACCCTAACCCTAACCCTAACCCTAGGTAGTCTGTAGACTGT
scaffold_923	forward	CGCCAAGCCGCTTCGGCCGGAGCGGAAATAACTAACCGCCGGGGTATACGTATGAGCATACGTATGTTCATACGTATGTGCATACGTACCCCGTTTCCAA
scaffold_999	forward	CCCTAACCCTAACCCTAACCCTAACCCTAACCCTAACCCTAACCCTAACCCTAACCCTAACCCTAAACCCTAACCCTAACCCTAACCCTAACCCTAACCC
scaffold_1028	reverse	CGAATTTTGATTCATGAATTCAAAGAATTTAGGGTTAGGGTTAGGGTTAGGGTTAGGGTTAGGGTTAGGGTTAGGGTTAGGGTTAGGGTTAGGGTTAGGG
scaffold_1099	forward	ACCCTAACCCTAACCCTAACCCTAACCCTAACCCTAACCCTAACCCTAACCCTAACCCTAACCCTAACCCTAACCCTAACCCTAACCCTAACCCTAACCC
scaffold_1111	reverse	AATCAGATCATCGACACGATTTAGGGGTTAGGGTTAGGGTTAGGGTTAGGGTTAGGGTTAGGGTTAGGGTTAGGGTTAGGGTTAGGGTTTAGGGTTAGGG
scaffold_1155	forward	CAGAACAGTGAGTTGCACACTACATTGTGATTCTCAAGCTTTAACTAACACAACTATAAAGGCTGATGACAAAGGTCAAACTCACAGCAACTGAGCATCT
scaffold_1166	reverse	GCGTTAGGGTTAGGGTTAGGGTTAGGGTTAGGGTTAGGGTTAGGGTTAGGGTTAGGGTTAGGGTTAGGGTTAGGGTTAGGGTTAGGGTTAGGGTTAGGGT
scaffold_1170	reverse	AAGTTAAAAAGCATCATGTGATTGCTATACAGTAAGATGATTGAGTAACAAGTTAGTAGTAAGTTAGTTATAACTTTAATTTAAACATGTGATCAGTTTG
scaffold_1223	forward	CCCTAACCCTAACCCTAACCCTAACCCTAACCCTAACCCTAACCCTAACCCTAACCCTAACCCTAACCCTAACCCTAACCCTAACCCTAACCCTAACCCG
scaffold_1235	forward	CCCTAACCCTAACCCTAACCCTAACCCTAACCCTAACCCTAACCCTAACCCTAACCCTAACCCTAACCCTAACAAAATGAACACTAAAGTCGATGCTCTA
scaffold_1242	forward	CCCTAACCCTAACCCTAACCCTAACCCTAACCCTAACCCTAACCCTAACCCTAACCCTAACCCTAACCCTAACCCTAACCCTAACCCTAGCCCTAGCCCT
scaffold_1296	forward	CCCTAACCCTAACCCTAACCCTAACCCTAACCCTAACCCTAACCCTAACCCTAACCCTAACCCTAACCCTAACCCTAACCCTAACCCTAACCCTAACCCT
scaffold_1335	forward	CCCTAACCCTAACCCTAACCCTAACCCTAACCCTAACCCTAACCCTAACCCTAACCCTAACCCTAACCCTAACCCTGAGAGAAGGTAGAAGTTGTTGAGA
scaffold_1354	forward	ATGCTTCTGCTGTCAACGATTACTTCTTTTGACTGAAATAACTAACAACGACTCGCTGATAACAGTTAACAGACTATGAAGCAAAAGCACTAAACTAAAG
scaffold_1380	reverse	CAATGAATATTTAGGGTTAGGGTTAGGGTTAGGGTTAGGGTTAGGGTTAGGGTTAGGGTTAGGGTTAGGGTTAGGGTTAGGGTTAGGGTTAGGGTTAGGG
scaffold_1402	forward	CCCTAACCCTAACCCTAACCCTAACCCTAACCCTAACCCTAACCCTAACCCTAACCCTAACCCTAACCCTAACCCTCTCGTTCTTTTCATTCTTCTGTCA
scaffold_1409	reverse	GTTGGAAACGGGGTACGTATGCACATACGTATGAACATACGTATGCTCATACGTATACCCCGGCGGTTAGTTATTTCCGCTCCGGCCGAAGCGGCTTGGC
scaffold_1415	reverse	ACATCTTTGCAAATCATTTGCTGCTCACTTAGGGTTAGGGTTAGGGTTAGGGTTAGGGTTAGGGTTAGGGTTAGGGTTAGGGTTAGGGTTAGGGTTAGGG
scaffold_1445	reverse	TTAGGGTTATTAGGGTTAGGGTTAGGGTTAGGGTTAGGGTTAGGGTTAGGGTTAGGGTTAGGGTTAGGGTTAGGGTTAGGGTTAGGGTTAGGGTTAGGGT
scaffold_1455	reverse	CAATGAAAATTTAGGGTTAGGGTTAGGGTTAGGGTTAGGGTTAGGGTTAGGGTTAGGGTTAGGGTTAGGGTTAGGGTTAGGGTTAGGGTTAGGGTTAGGG
scaffold_1556	forward	TAACCCTAACCCTAACCCTAACCCTAACCCTAACCCTAACCCTAACCCTAACCCTAACCCTAACCCTAACCCTAACCCTAACCCTAACCCTAACCCTAAC
scaffold_1935	reverse	ACCTTGTTTTTTAAACAGGGTTAGGGTTAGGGTTAGGGTTAGGGTTAGGGTTAGGGTTAGGGTTAGGGTTAGGGTTAGGGTTAGGGTTAGGGTTAGGGTT
scaffold_1992	forward	CCCTAACCCTAACCCTAACCCTAACCCTAACCCTAACCCTAACCCTAACCCTAACCCTAACCCTAACCCTTAATGTTTTTAACGTCAAATTCTTCAATGT
scaffold_2014	forward	CCCTAACCCTAACCCTAACCCTAACCCTAACCCTAACCCTAACCCTAACCCTAACCCTAACCCTAACCCTAACCCTAACCCTAACCCGCATAGCGGTGAC
scaffold_2094	reverse	GATTTCAACTATAGGGTTAGGGTTAGGGTTAGGGTTAGGGTTAGGGTTAGGGTTAGGGTTAGGGTTAGGGTTAGGGTTAGGGTTAGGGTTAGGGTTAGGG
scaffold_2159	forward	GCGCCAAGCCGCTTCGGCCGGAGCGGAAATAACTAACCGCCGAGGTATACGTATGAGCATACGTATGTTCATACGTATGTGCATACGTACCTCGTTTCCA
scaffold_2191	forward	CCCTAACCCTAACCCTAACCCTAACCCTAACCCTAACCCTAACCCTAACCCTAACCCTAACCCTAACCCTAACTTTGAAGAATGAATTATGTTAAGTTGT
scaffold_2363	reverse	AAAGATGTGGCCCGGGCTAGGTCTAGGTCTAGGGTTAGGGTTAGGGTTAGGGTTAGGGTTAGGGTTAGGGTTAGGGTTAGGGTTAGGGTTAGGGTTAGGG
scaffold_2365	forward	TTCTTTCTTGTTTTTCAATTTACTTTGTAACTAACAATTTTTCAGCAAACCCATGAAGTGTAATGATGTTCTGATGTTATCTATCAATTTCTTCAGTGAT
scaffold_2585	reverse	CACTTATAAAGTTAAAAGTCATCATGTGATCAACATACTGTGAGATAATTGAGTAACAAGTTAGTAGTAAGTTAGTTATAACTTTAATTTGAACACATGA
scaffold_2656	forward	TTTACTTTGTAACTAACAATTTTTCAGCAAACCCATGAAGTGTAATGATGTTCTGATGTTATCTATCAATTTCTTCAGTGATTTAGGCTATGAAGATCCT
scaffold_2671	forward	AATGATTGTATGAATATCAAGTATGTACACAACAGATAACTAACTTCATGACTTAAAAATCTTATATTATTCTTAGTATTTCTTGTAATAGATTGACCTT
scaffold_2722	forward	GATTGGACTACTCTACTAACTAACCACAGGGGTAACCATACTCCCTGTTTCCAACCACGCCGGCCCAGCTCCTCTTTGCGTTTGGAATACGAGGTCATAT

Telomeres found: 64 (36 forward, 28 reverse)
