scaffold_17	forward	AGGCAGTAGGAACACTTTGTTCGTGCTCATCATTTACCACAACCAACGTCACCCTCATATTGCAGACTTAACCCTAACCCTAACCCTAACCTGTATCTTC
scaffold_19	forward	TTACTTGACTGTAGGCAGTAGGAATACTTTGTTCGTGCTCATCAATTACCACAACCAACGTCACCCTCATATTGCAGACTTAACCCTAACCCTAACCCTA
scaffold_48	reverse	GCAATATGAGTTAGGGTTAAGTCTGCAATATGAGGGTGACGTTGGTTGTGGTAACCGATGAGCACGAACAAAGTATTCCAACTGCCTACAGCCAAGTAAA
scaffold_54	reverse	TCTATAATAGGGTTAGGGTTAAGTCTGCAATATGAGGGTGACGTTGGTTGTGGTAATTGATGAGCACGAACAAAGTGTTCCTACTGTCTACAGTCAAGTA
scaffold_56	forward	ACCCTAACCCTAACCCTAACCCTAACCCTAACCCTAACCCTAACCCTAACCCTAACCCTAACCCTAACCCTAACCCTAACCCTAACCCTAATCTTGTGTA
scaffold_60	forward	ACCAACGTCACCCTCATATTGCAGACTTAACCCTAACCCTAACCCCGATATGGTGAAGCTTCATGATAGAAGACCTCACCAGGGCTTGGCGTCTGCACTC
scaffold_61	reverse	AGTTAGGGTTAGGGTTAGGGTTAAGTCTGCAATATGAGGGTGACGTTGGTTGTGGTAATTGATGAGCACGAACAAAGTGTTCCTACTGTCTACAGTCAAG
scaffold_62	forward	ACCCTAACCCTAACCCTAACCCTAACCCTAACCCTAACCCTAACCCTAACCCTAACCCTAACCCTAACCCTAACCCTAACCCTAACCCTAAGAACTAGCA
scaffold_71	forward	GTAGGCAGTTGGAATACTTTGTTCGTGCTCATCGGTTACCACAACCAACGTCACCCTCATATTGCAGACTTAACCCTAACCCTAACCCTAACTTTTGTCT
scaffold_73	reverse	GAAAACTTAGGGTTAGGGTTAGGGTTAAGTCTGCAATATGAGGGTGACGTTGGTTGTGGTAACCGATGAGCACGAACAAAGTATTCCAACTGCCTACAGC
scaffold_76	reverse	TTCCAAACCATTAGGGTTAGGGTTAGGGTTAGGGTTAGGGTTAGGGTTAGGGTTAGGGTTAGGGTTAGGGTTAGGGTTAGGGTTAGGGTTAGGGTTAGGG
scaffold_78	forward	CTTGGCTGTAGGCAGTTGGAATACTTTGTTCGTGCTCATCGGTTACCACAACCAACGTCACCCTCATATTGCAGACTTAACCCTAACCCTAGGTCTGAGT
scaffold_80	forward	TAGGCAGTTGGAATACTTTGTTCGTGCTCATCGGTTACCACAACCAACGTCACCCTCATATTGCAGACTTAACCCTAACCCTAACCCTAAGATGTGAGAA
scaffold_81	reverse	AGATCTTAATTAGGGTTAGGGTTAAGTCTGCAATATGAGGGTGACGTTGGTTGTGGTAACCGATGAGCACGAACAAAGTATTCCAACTGCCTACAGCCAA
scaffold_84	reverse	ATTCAATTGGGGTTAGGGTTAGGGTTAGGGTTAGGGTTAGGGTTAGGGTTAGGGTTAGGGTTAGGGTTAGGGTTAGGGTTAGGGTTAGGGTTAGGGTTAG
scaffold_89	reverse	AAGTATTCCAGGGTTAGGGTTAGGGTTAAGTCTGCAATATGAGGGTGACGTTGGTTGTGGTAACCGATGAGCACGAACAAAGTATTCCAACTGCCTACAG
scaffold_108	reverse	CCGGGGTTAGGGTTAGGGTTAAGTCTGCAATATGAGGGTGACGTTGGTTGTGGTAACCGATGAGCACGAACAAAGTATTCCAACTGCCTACAGCCAAGTA
scaffold_113	reverse	ATGATTTTTGGGTTAGGGTTAGGGTTAGGGTTAGGGTTAGGGTTAGGGTTAGGGTTAGGGTTAGGGTTAGGGTTAGGGTTAGGGTTAGGGTTAGGGTTAG
scaffold_118	reverse	TTTCTTAATGGGTTAGGGTTAGGGTTAGGGTTAGGGTTAGGGTTAAGTCTGCAATATGAGGGTGACGTTGGTTGTGGTAATTGATGAGCACGAACAAAGT
scaffold_120	reverse	CAGTGCCTTTTATTGGAAGAGTGCAGGCGCCAAGCCCTGGTGAGGTCTTCTATCGTGAAGCTTCACCATATCGGGGTTAGGGTTAGGGTTAGGGTTAGGG
scaffold_128	reverse	TGCTGAAATTTAGGGTTAGGGTTAGGGTTAAGTCTGCAATATGAGGGTGACGTTGGTTGTGGTAAATGATGAGCACGAACAAAGTGTTCCTACTGCCTAC
scaffold_140	reverse	AAAAAATGGGTTAGGGTTAGGGTTAGGGTTAAGTCTGCAATATGAGGGTGACGTTGGTTGTGGTAACCGATGAGCACGAACAAAGTATTCCAACTGCCTA
scaffold_208	reverse	TAACTTAGAATTAGGGTTAGGGTTAGGGTTAGGGTTAGGGTTAGGGTTAGGGTTAGGGTTAGGGTTAGGGTTAGGGTTAGGGTTAGGGTTAGGGTTAGGG

Telomeres found: 23 (8 forward, 15 reverse)
