scaffold_12	reverse	ACTTCCTATTTAGGGTTAGGGTTAGGGTTAGGGTTAGGGTTAGGGTTAGGGTTAGGGTTAGGGTTAGGGTTAGGGTTAGGGTTAGGGTTAGGGTTAGGGT
scaffold_34	reverse	GTAGTTTCCTTTAGGGTTAGGGTTAGGGTTAGGGTTAGGGTTAGGGTTAGGGTTAGGGTTAGGGTTAGGGTTAGGGTTAGGGTTAGGGTTAGGGTTAGGG
scaffold_67	forward	ATTATAAGTATATTATTATTTTATTTAATCTTAATAAAATTATATTAAAATTATATTAAGTATTCTATAACTAACTTTTATTAATTTAAATATTAAATAA
scaffold_75	reverse	TTAGGACTATTAGGGTTAGGGTTAGGGTTAGGGTTAGGGTTAGGGTTAGGGTTAGGGTTAGGGTTAGGGTTAGGGTTAGGGTTAGGGTTAGGGTTAGGGT
scaffold_80	reverse	AGGGTTAGGTTTAGGGTTAGGGTTAGGGTTAGGGTTAGGGTTAGGGTTAGGGTTAGGGTTAGGGTTAGGGTTAGGGTTAGGGTTAGGGTTAGGGTTAGGG
scaffold_86	forward	TAACCCTAACCCTAACCCTAACCCTAACCCTAACCCTAACCCTAACCCTAACCCTAACCCTAACCCTAACCCTAACCCTAACCCTAACCCTTTCATAATC
scaffold_95	reverse	ATTATTATATTAAGACTTAGGGTTAGGGTTAGGGTTAGGGTTAGGGTTAGGGTTAGGGTTAGGGTTAGGGTTAGGGTTAGGGTTAGGGTTAGGGTTAGGG
scaffold_122	forward	GTTTTTCAATATTCCCCCCTTTTTTTTTCCCTTTTTGTGTGCGTTTATTTCCCTAACTAACAACCCCCCCCGACCATACTCCACCAAGCGCACGGGAACG
scaffold_125	forward	ATTAATAGCCTATTAATATACCTTAACTAACTTATTATATATAATAATAATTTTAAGTAAGGTGAGATAAGCTTTAATAAAATAATTAAGTAAAAGTATT
scaffold_139	reverse	GTACGTGTTCTTAGGGTTAGGGTTAGGGTTAGGGTTAGGGTTAGGGTTAGGGTTAGGGTTAGGGTTAGGGTTAGGGTTAGGGTTAGGGTTAGGGTTAGGG
scaffold_140	forward	CCCTAACCCTAACCCTAACCCTAACCCTAACCCTAACCCTAACCCTAACCCTAACCCTAACCCTAACCCTAACCCTAACCCTAACCCTAAGTTTCTATAA
scaffold_143	forward	CTAACCCTAACCCTAACCCTAACCCTAACCCTAACCCTAACCCTAACCCTAACCCTAACCCTAACCCTAACCCTAACCCTAACCCTAAGAATTGGGTTCA
scaffold_147	forward	CTAACCCTAACCCTAACCCTAACCCTAACCCTAACCCTAACCCTAACCCTAACCCTAACCCTAACCCTAACCCTAACCCTAACCCTAAATATGGAGTAAC
scaffold_166	forward	CCTAACCCTAACCCTAACCCTAACCCTAACCCTAACCCTAACCCTAACCCTAACCCTAACCCTAACCCTAACCCTAACCCTAACCCTAAAGATTTGATAG
scaffold_171	reverse	AATATAAAGAGATATAATAGCCTTAAAATCTCTTCCTATTGTCTATTATTATATAAAGTTAGTTATAAAGTTAAAAGTATATTAAAGTATTATATATATA
scaffold_178	forward	ACCCTAACCCTAACCCTAACCCTAACCCTAACCCTAACCCTAACCCTAACCCTAACCCTAACCCTAACCCTAACCCTAACCCTAACCCTAAGGGGTGGAA
scaffold_185	reverse	TAGAAAATTTAAAAGGGTTAGGGTTAGGGTTAGGGTTAGGGTTAGGGTTAGGGTTAGGGTTAGGGTTAGGGTTAGGGTTAGGGTTAGGGTTAGGGTTAGG
scaffold_270	forward	ACCCTAACCCTAACCCTAACCCTAACCCTAACCCTAACCCTAACCCTAACCCTAACCCTAACCCTAACCCTAACCCTAACCCTAACCCTTTTATACTCCC
scaffold_315	forward	TTAATATTACCTTTATTATTAGTACTTTAAGTTATTTCCTTAATAACCTAACTAAAGATTATATAAAGGTAGTAAAATAAGTATTATAATATTTAATAAA
scaffold_327	forward	CCCTAACCCTAACCCTAACCCTAACCCTAACCCTAACCCTAACCCTAACCCTAACCCTAACCCTAACCCTAACCCTAACCCTAACCCTAAGCGAAGGCCA
scaffold_329	forward	TAACCCTAACCCTAACCCTAACCCTAACCCTAACCCTAACCCTAACCCTAACCCTAACCCTAACCCTAACCCTAACCCTAACCCTAAGCGACTATATATA
scaffold_333	reverse	CTCTGCAGGCCCTTAGGGTTAGGGTTAGGGTTAGGGTTAGGGTTAGGGTTAGGGTTAGGGTTAGGGTTAGGGTTAGGGTTAGGGTTAGGGTTAGGGTTAG
scaffold_341	reverse	AGGGTTAGGATAAGGGTTAGGGTTAGGGTTAGGGTTAGGGTTAGGGTTAGGGTTAGGGTTAGGGTTAGGGTTAGGGTTAGGGTTAGGGTTAGGGTTAGGG
scaffold_378	forward	AACCCTAACCCTAACCCTAACCCTAACCCTAACCCTAACCCTAACCCTAACCCTAACCCTAACCCTAACCCTAACCCTAACCCTAACCCTACGCTAGGTC
scaffold_452	reverse	GTAAAAGAACTTTAGGGTTAGGGTTAGGGTTAGGGTTAGGGTTAGGGTTAGGGTTAGGGTTAGGGTTAGGGTTAGGGTTAGGGTTAGGGTTAGGGTTAGG
scaffold_472	forward	CTAACCCTAACCCTAACCCTAACCCTAACCCTAACCCTAACCCTAACCCTAACCCTAACCCTAACCCTAACCCTAACCCTAACCCTAACCCCAATAAGTA
scaffold_478	forward	TAACCCTAACCCTAACCCTAACCCTAACCCTAACCCTAACCCTAACCCTAACCCTAACCCTAACCCTAACCCTAACCCTAACCCTAAATATCGGAGAGAA
scaffold_523	reverse	TTATAATATTATTAGGGTTAGGGTTAGGGTTAGGGTTAGGGTTAGGGTTAGGGTTAGGGTTAGGGTTAGGGTTAGGGTTAGGGTTAGGGTTAGGGTTAGG
scaffold_534	reverse	GTGGAAAGGTATTTATTAATAAATATAATTATGCTTATAGTTCTAGATAACTTAGCCTTAAAGCTAAGGTCAGGGTTAGGGTCAGAGTTAGGGTTAGGGT
scaffold_585	forward	TTAATATTACCTTTATTATTAGTACTTTAAGTTATTTCCTTAATAACCTAACTAAAGATTATATAAAGGTAGTAAAATAAGTATTATAATACTTAATAAA
scaffold_614	reverse	AGGTAATAGGTAATATATATTTATAAGTTTTTAGTAAGATAATAAATATATATTAAGTAAGAAAGTTAGTTATAATACTAGTAATATCTACTATAATTAG
scaffold_636	reverse	TATTAGCTAGTTTAGGGTTAGGGTTAGGGTTAGGGTTAGGGTTAGGGTTAGGGTTAGGGTTAGGGTTAGGGTTAGGGTTAGGGTTAGGGTTAGGGTTAGG
scaffold_673	reverse	AAAAGATAATATTAGGGTTAGGGTTAGGGTTAGGGTTAGGGTTAGGGTTAGGGTTAGGGTTAGGGTTAGGGTTAGGGTTAGGGTTAGGGTTAGGGTTAGG
scaffold_682	forward	CCTAACCCTAACCCTAACCCTAACCCTAACCCTAACCCTAACCCTAACCCTAACCCTAACCCTAACCCTAACCCTAACCCTAACCCTAAATCTAAATCTA
scaffold_687	forward	AACCCTAACCCTAACCCTAACCCTAACCCTAACCCTAACCCTAACCCTAACCCTAACCCTAACCCTAACCCTAACCCTAACCCTAACCCTAGGTTAATAG
scaffold_772	forward	ATAAAGAGGTTATTACTTAAATAACTTTTTATAATATTAATAACTAACTCTTATTTAAGCTCATATTTTATAAATAATAATATAATAGATATATTAACTT
scaffold_792	reverse	AAAAAGACTTCTTTAGGGTTAGGGTTAGGGTTAGGGTTAGGGTTAGGGTTAGGGTTAGGGTTAGGGTTAGGGTTAGGGTTAGGGTTAGGGTTAGGGTTAG
scaffold_793	forward	ATTTATTATTAGGTTAACTAACTTAAATAACTTAATAATAAAGTTTATTATAATATCTTTTTATAATATATCTAGAACTTTTATAAAATAAATTTATCTA
scaffold_839	forward	CCCTAACCCTAACCCTAACCCTAACCCTAACCCTAACCCTAACCCTAACCCTAACCCTAACCCTAACCCTAACCCTAACCCTAACCCTAAAATTTATTAA
scaffold_848	reverse	GGTGGTCCGTCTTAGGGTTAGGGTTAGGGTTAGGGTTAGGGTTAGGGTTAGGGTTAGGGTTAGGGTTAGGGTTAGGGTTAGGGTTAGGGTTAGGGTTAGG
scaffold_885	forward	CTAATTATAGTAGATATTACTAGTATTATAACTAACTTTCTTACTTAATATATATTTATTATCTTACTAAAAACTTATAAATATATATTACTTATTACCT
scaffold_905	forward	CCTAACCCTAACCCTAACCCTAACCCTAACCCTAACCCTAACCCTAACCCTAACCCTAACCCTAACCCTAACCCTAACCCTAACCCTAACCTAATTATAT
scaffold_924	reverse	AAGACTAGGATTCTTAGGGTTAGGGTTAGGGTTAGGGTTAGGGTTAGGGTTAGGGTTAGGGTTAGGGTTAGGGTTAGGGTTAGGGTTAGGGTTAGGGTTA
scaffold_950	forward	CCCTAACCCTAACCCTAACCCTAACCCTAACCCTAACCCTAACCCTAACCCTAACCCTAACCCTAACCCTAACCCTAACCCTAAGTAAGAATCGGGGTTA
scaffold_1018	forward	ACCCTAACCCTAACCCTAACCCTAACCCTAACCCTAACCCTAACCCTAACCCTAACCCTAACCCTAACCCTAACCCTAACCCTAACCCTTTATATAACCC
scaffold_1189	reverse	TATTATATTAACTTAGGGTTAGGGTTAGGGTTAGGGTTAGGGTTAGGGTTAGGGTTAGGGTTAGGGTTAGGGTTAGGGTTAGGGTTAGGGTTAGGGTTAG
scaffold_1304	forward	TATATATTTATATTTTACCACTTTAATTCCTAAGATAATAACTAACCTTTATTAATTAAAATTAATTAAAATTAATATCATAAAACTTTTTAAATATTTA
scaffold_1406	reverse	GATAAAAAGAAAAAAATTAGGGTTAGGGTTAGGGTTAGGGTTAGGGTTAGGGTTAGGGTTAGGGTTAGGGTTAGGGTTAGGGTTAGGGTTAGGGTTAGGG

Telomeres found: 48 (27 forward, 21 reverse)
