scaffold_51	forward	CCTAACCCTAACCCTAACCCTAACCCTAACCCTAACCCTAACCCTAACCCTAACCCTAACCCTAACCCTAACCCTAAGAGACCTACAGAAGGTTGACACA
scaffold_63	forward	CCCTCACCCTAACCCTAACCCTAACCCTAACCCTAACCCTAACCCTAACCCTAACCCTAACCCTAACCCTATACTATTTATAGTAAGGCTTTAATAGTTA
scaffold_65	forward	ACCCTAACCCTAACCCTAACCCTAACCCTAACCCTAACCCTAACCCTAACCCTAACCCTAACCCTAAGACTATCTCGAAGAAAGAAAGAAGAAATAGAAG
scaffold_74	forward	TAACCCTAACCCTAACCCTAACCCTAACCCTAACCCTAACCCTAACCCTAACCCTAACCCTAACCCTAACCCTAAGAAGCTCCTTAGATAGACTAATAAA
scaffold_90	reverse	GGGTTAGGGTTAGGGTTAGGGTTAGGGTTAGGGTTAGGGTTAGGGGTAGGGTTAGGGTTAGGGTTAGGGTTAGGGTTAGGGTTAGGGTTAGGGTTAGGGT
scaffold_92	reverse	TATTAGGGTTAGGGTTAGGGTTAGGGTTAGGGTTAGGGTTAGGGTTAGGGTTAGGGTTAGGGTTAGGGTTAGGGTTAGGGTTAGGGTTAGGGTTAGGGTT
scaffold_98	reverse	AGAGAAAGATATAAGAGAAGAGAGTTAGGGTTAGGGTTAGGGTTAGGGTTAGGGTTAGGGTTAGGGTTAGGGTTAGGGTTAGGGTTAGGGTTAGGGTTAG
scaffold_134	reverse	AATTACTTAGAGACGAGCGCTATTTAGGGTTAGGGTTAGGGTTAGGGTTAGGGTTAGGGTTAGGGTTAGGGTTAGGGTTAGGGTTAGGGTTAGGGTTAGG
scaffold_150	forward	CTAACCCTAACCCTAACCCTAACCCTAACCCTAACCCTAACCCTAACCCTAACCCTAACCCTAACCCTAACCCTAACCCTAACCCTAACCCTAACCCTAA
scaffold_162	reverse	TACGGGTAACCTAAGGCGGGTACGGGTTAGGGTTAGGGTTAGGGTTAGGGTTAGGGTTAGGGTTAGGGTTAGGGTTAGGGTTAGGGTTAGGGTTAGGGTT
scaffold_163	forward	AACCCTAACCCTAACCCTAACCCTAACCCTAACCCTAACCCTAACCCTAACCCTAACCCTAACCCTAACCCTAATAGTATAGAAGAGAAGTCTCTTATAA
scaffold_228	reverse	CCGACCGCCTACTACTCTACCGCTATGCTATTCTAATCCGACTGCCTTAGGGTTAGGGTTAGGGTTAGGGTTAGGGTTAGGGTTAGGGTTAGGGTTAGGG
scaffold_233	forward	TAACCCTAACCCTAACCCTAACCCTAACCCTAACCCTAACCCTAACCCTAACCCTAACCCTAACCCTAACCCTAACTAACCCTAACTCTATTTATATAAA
scaffold_237	reverse	GATGGGAACAGCATCGAACTGGGAATGAGGTACGGAACTATACAACTTAAGTGTTGCGCATGCTACGGAGGCGTCCCAAAAGTGAGTGCAGTTAGGGTTA
scaffold_272	forward	CCTAACCCTAACCCTAACCCTAACCCTAACCCTAACCCTAACCCTAACCCTAACCCTAACCCTAACCCTAACCCTAATTTATATACTTTAGTTATACTAA
scaffold_291	reverse	GAGCCCGTACGTAAGCTTTCGGGTATTAGGGTTAGGGTTAGGGTTAGGGTTAGGGTTAGGGTTAGGGTTAGGGTTAGGGTTAGGGTTAGGGTTAGGGTTA
scaffold_319	reverse	TTATAAGGTTAGTTAAAATTATTCTTTTTTATCGTTTAAGTTAAAATTCTTTATCGTAAGCTCCTATTCTCTTACCTAAGGTAGTAAAGTAGGTAATCTA
scaffold_360	reverse	AGTTAGTTAATCAAGTACAGTATTGCCAGTTGAATTCGTACTGCCAGTTAGTCAATCAAGTACAGTATTGCCAGTTGAATTCGTACTGCCAGTTAGTCAA
scaffold_420	reverse	GATCTAGGGTATAGCCGGTACGGTAGTTAGTAATCTAATAGATATTAGATTAACTTCGAATTTAGGTACGAATAAAACGTTAGTTAAAACGCCTTTTCTT
scaffold_469	forward	ATAGTTAATTAATTAACTAGTAGTACGAATTCAACTAGTAATACTATACTTAATTAACTAACTAGTAGTACGAATTCAACTAGTAATACTATACTTAATT
scaffold_713	forward	AGAGAATAGGAGCTTACGATAAAGAATTTTAACTTAAACGATAAAAAAAGATAATTTTAACTAACCTTATAATAGTTCGGTAGATTTCTTCTAAGGTTAA
scaffold_909	reverse	TTTATACACAACTAATAGTTTTGATAAGTTAACCGTAGAAGAAATTCACTAGACTATTATAAGGTTAGTTAAAATTATCCTTTTTTATCGTTTAAGTTAA
scaffold_929	forward	ACCCTAACCCTAACCCTAACCCTAACCCTAACCCTAACCCTAACCCTAACCCTAACCCTAACCCTAACCCTAAATAGGTAATAAAAATAAATAGTAGCTT
scaffold_939	forward	AATAGGAGCTTACGATAAAGAATTTTAACTTAAACGATAAAAAAGAATAATTTTAACTAACCTTATAATAGTCTAGTAAATTTCTTTTACGGTTAACTTA
scaffold_956	forward	AATTTTAACTAACCTTATAATAGTCTAGTGAATTTCTTCTACGGTTAACTTATTAAAACTATTAGTTATATACGAAACATCTAGATTATCTACTTTACTA
scaffold_1023	reverse	GGGTTAGGGTTAGGGTTAGGGTTAGGGTTAGGGTTAGGGTTAGGGTTAGGGTTAGGGTTAGGGTTAGGTTAGGGTTAGGGTTAGGGTTAGGGTTAGGGTT
scaffold_1035	reverse	CTATAGGCTTTAATCGACCCGTATCTTAGGGTTAGGGTTAGGGTTAGGGTTAGGGTTAGGGTTAGGGTTAGGGTTAGGGTTAGGGTTAGGGTTAGGGTTA
scaffold_1078	reverse	ACAGTACTGCTAGTTGAATTCGTACTGCTAGTTAGTTAATTAAGTATAGTATTGCTAGTTGAATTCGTACTACTAGTCAGTTAATTAAGTACAGTATTGC
scaffold_1083	forward	TAACTAACCTTATAATAGTCCGATAGATTTCTTCTAAGGTTAATCGCTCTAATAGAGGTATATCTATAGTTAATATCTACGGCGACTTACTTATCTTAAT
scaffold_1099	forward	AAAAAGATAATTTTAACTAACCTTATAATAGTTTAGTGAATTTCTTCTAAGGTTAACTTATAAAAACTATTAGTTATATACGAAACATCTAGATTACCTA
scaffold_1138	forward	AAGAAAAGGCGTTTTAACTAACGTTTTATTCGTACCTAAATTCGAAGTTAATCTAATATCTATTAGATTACTAACTAAAAGAGGCTTAACAATTTAATTT
scaffold_1230	forward	ACTACCTTAGGTAAGAGAATAGGAGCTTACGATAAAGAATTTTAACTTAAACGATAAAAAAGGATAATTTTAACTAACCTTATAATAGTCTAGTGAATTT
scaffold_1259	reverse	GTTAGTTAAAACGCCTTTTCTTTCTATATCGGTAAAGATAATAGGCATATTACCTATACCACTAGCCTTAATTCGAGTAGTCTCACCCCACTTAATATAA
scaffold_1413	forward	TAACTAACGTTTTATTCGTACCTGAATTCGAAGTTAATCTAATATCTATTAGATTACTAACTAGAAGAGGCTTAACAGTTTAATTTACTAAGTCTTGCAC
scaffold_1491	reverse	ACTTAGAGACAAGCGCTATTTAGCTCTTAGGGTTAGGGTTAGGGTTAGGGTTAGGGTTAGGGTTAGGGTTAGGGTTAGGGTTAGGGTTAGGGTTAGGGTT
scaffold_1519	reverse	TTCTTAGAAAGCTCTTTAGGCGTGCGAACTTTATTTAGGGTTAGGGTTAGGGTTAGGGTTAGGGTTAGGGTTAGGGTTAGGGTTAGGGTTAGGGTTAGGG
scaffold_1522	forward	GCTTAGTAAAAACCGGTATCGACGGCAGTTTAGGCCCGAACTACTACTAAGTAGGACTATACTAGGCCCGTTTAGGGGGGGTTAACCCTAACTCTAATTA
scaffold_1525	forward	TAGGAGCTTACGATAAAGAATTTTAACTTAAACGATAAAAAAGAATAATTTTAACTAACCTTATAATAGTCTAGTGAGTTTCTTCTACGGTTAACTTATT

Telomeres found: 38 (20 forward, 18 reverse)
