scaffold_1	forward	CCCTAACCCTAACCCTAACCCTAACCCTAACCCTAACCCTAACCTAACCCTAACCCTAACCCTAACCTAACCCTAAGACGAGGACGAGCTAGATGAGCGT
scaffold_5	forward	CCCTAACCCTAACCCTAACCCTAACCCTAACCCTAACCCTAACCCTAACCCAAACCTTAACCCTAACCTAACCCTAACCCTAAGCCGACTTGATGATGAT
scaffold_5	reverse	CTCGCCGCATTCGACGCTGTCGCTCGTACTTAGGGTTAGGTTAGGGTTAGGGTTAGGGTTAGGGTTAGGGTTAGGGTTAGGGTTAGGGTTAGGGTTAGGG
scaffold_6	reverse	ATACATTGGCTGCAGTTTTTGAGATGGCCAAGGGTTAGGGTTAGAGTTAGGTTAGGGTTAGGGTTAGGGTTAGGGTTAGGGTTAGGGTTAGGGTTAGGGT
scaffold_15	reverse	CCATGTCTAAATAAGGTGGAGGCACACATAAAATCTTAGGGTTAGGGTTAGGTTAGGGTTAGGGTTAGGGTTAGGGTTAGGGTTAGGGTTAGGGTTAGGG
scaffold_16	reverse	GGGAGGATCGTCGCATTGGTGTTAGGGTTAGGGTTAGGTTAGGGTTAGGGTTAGGGTTAGGGTTAGGGTTAGGGTTAGGGTTAGGGTTAGGGTTAGGGTT
scaffold_19	reverse	TGGTGTGCTTTTCTTACGGCGCTCGCCTCTTGCTTTGGGTTAGGGTTAGGGTTAGGGTTAGGGTTAGGGTTAGGGTTAGGGTTAGGGGTTAGGGTTAGGG
scaffold_20	reverse	CCGTTGCAGGACAACCTCTGGCGCAGACCTTAGGGTTAGGTTAGGGTTAGGGTTAGGGTTAGGGTTAGGGTTAGGGTTAGGGTTAGGGTTAGGGTTAGGG
scaffold_23	forward	CCCTAACCCTAACCCTAACCCTAACCCTAACCCTAACCCTAACCCTAACCCTAACCCTAACCCTAACCCTAACCTCGCTTTCACGTGCGCGGAAGCGCAC
scaffold_31	forward	CCCTAACCCTAACCCTAACCCTAACCCTAACCCTAACCCTAACCCTAACCCTAACCCTAACCATAACCCTCAGCTCAAGCGTTGTGTCGAATAGTCGGAG
scaffold_33	forward	CCCTAACCCTAACCCTAACCCTAACCCTAACCCTAACCCTAACCCTAACCCTAACCCTAACCCTAACCCTAACAGTGCACTTGGCTCGCGGGCCCGAAGT
scaffold_35	forward	ACCCTAACCTAACCCTAACCTAACCCTAACCCTAACCCTAACCCTAACCCTAACCCTAACCTTGACCCTTAACCCTAACCCTGACCTAACCCTAACCTAA
scaffold_39	forward	CCCTAACCCTAACCCTAACCCTAACCCTAACCCTAACCCTAACCCTAACCTAACCCTAACCCTAACCCTTTTTCTCCTCTCCTTGCCGCTACATCACGCT
scaffold_40	forward	CCCTAACCCTAACCCTAACCCTAACCCTAACCCTAACCCTAACCTAACCCTAACCTAACCCTAACCCTAAGAGGGAACGCACCTTGAGAAAGAGCTCCTC
scaffold_42	reverse	CGTTGACTGAAACGATCGCCTCCGCACTTAGGGTTAGGGTTAGGGTTAGGGTTAGGGTTAGGGTTAGGGTTAGGGTTAGGGTTAGGGTTAGGGTTAGGTT
scaffold_48	forward	CCCTAACCCTAACCCTAACCCTAACCCTAACCCTAACCCTAACCCTAACCCTAACCCTAACCTAACCCTAATGTGTGGCCACACCTATCACGACCATATC
scaffold_51	reverse	TTCACTCGCTAATTTGGGTTAGGGTTAGGTTAAGTTAGAGTTAGGGCTAGAGTTAGGGTTAGGGCTAGGGTTAGGGTTAGGGTTAGGGTTAGGGTTAGGG
scaffold_68	reverse	GTCGTGTCGCGACCGTGGTGCGTAAATGCTTAGGGTTAGGGTTAGGTTAGGGTTAGGGTTAGGGTTAGGGTTAGGGTTAGGGTTAGGGTTAGGGTTAGGG
scaffold_71	forward	CCCTAACCCTAACCCTAACCCTAACCCTAACCCTAACCCTAACCTAACCTAACCCTAACCTAACCCTAACCTAACCTTGAGGGCGGCTACCTGCTGCAGG
scaffold_81	reverse	TGTCCTGTTAGCGCGGGAACAGTTGTCAGTGTCGAAGGGTTAGGTTAGGATTAGGGTTAGGGTTAGGGTTAGGGTTAGGGTTAGGGTTAGGGTTAGGGTT
scaffold_82	reverse	GGGCCGATTCGGTGCTTCTTTGACGAGAGGCAGTCTGCGGTTAGGGTTAGGGTTAGGGTTAGGGTTAGGGTTAGGGTTAGGGTTAGGGTTAGGGTTAGGG
scaffold_83	forward	ACCCTAACCCTAACCCTAACCCTAACCCTAACCCTAACCCTAACCCTAACCCTAACCTAACCCTAACCGAAGAGCGCCATGGCCAGCAAACAAGCGGATG
scaffold_91	forward	CCCTAACCCTAACCCTAACCCTAACCCTAACCCTAACCCTAACCCTAACCCTAACCTAACCCTAACCTAACTCGCTCCCAAAATTCAGGACTCGAGCAGA
scaffold_96	forward	CCCTAACCCTAACCCTAACCCTAACCCTAACCCTAACCCTAACCCTAACCCTAACCCTAACCCTAACCCTAACCTAACCCTAAGGGCTGTGTCTCGAGTC
scaffold_100	forward	CCCTAACCCTAACCCTAACCCTAACCCTAACCCTAACCCTAACCCTAACCCTAACCCTAACCCTAACCCTAACCCTAACCTAACCCTAACGCAGTAGGCG
scaffold_102	reverse	CGCTTCTTGTACCCAACTTGTGGTTAGGGTTAGGTTAGGGTTAGGGTTAGGGTTAGGGTTAGGGTTAGGGTTAGGGTTAGGGTTAGGGTTAGGGTTAGGG
scaffold_110	reverse	TCAGCCGGTTACGGTCATCGATCCTGAGGGTTAGGGTTAGGGTTAGGTTAGGGTTAGGTTAGGGTTAGGGTTAGGGTTAGGGTTAGGGTTAGGGTTAGGG
scaffold_111	reverse	TGCATTGACCTTTTTTTTAGGGTTATGTTAGGGTTAGGGTTAGGGTTAGGGTTAGGGTTAGGGTTAGGGTTAGGGTTAGGGTTAGGGTTAGGGTTAGGGT
scaffold_116	forward	CCCTAACCCTAACCCTAACCCTAACCCTAACCCTAACCCTAACCCTAACCCTAACCCTAACCCTAACCCTAACGTATCTGAAAGGCTCGGCTCGGATGAC
scaffold_118	forward	AACCCTAACCCTAACCCTAACCCTAACCCTAACCCTAACCCTAACCCTAACCCTAACCCTAACCCTAACCCCTAACCCTAACCCTAACCCTAACGTGAAT
scaffold_123	reverse	ACGCCTGTTAGGTTAGGGTTAGGTTAGGGTTAGGGTTACTTAGGGTTAGGGTTAGGGTTAGGGTTAGGGTTAGGGTTAGGGTTAGGGTTAGGGTTAGGGT

Telomeres found: 31 (16 forward, 15 reverse)
