scaffold_12	reverse	AAAATCAGATTTAAAACTCAAAAAGGGTTAGGGTTAGGGTTAGGGTTAGGGTTAGGGTTAGGGTTAGGGTTAGGGTTAGGGTTAGGGTTAGGGTTAGGGT
scaffold_19	reverse	GCTGATAAGTCAACTGTTAAATGGGGTTAGGGTTAGGGTTAGGGTTAGGGTTAGGGTTAGGGTTAGGGTTAGGGTTAGGGTTAGGGTTAGGGTTAGGGTT
scaffold_23	forward	TAACCCTAACCCTAACCCTAACCCTAACCCTAACCCTAACCCTAACCCTAACCCTAACCCTAACCCTAACCCTAACCTATTAAAGGGGTTTATCATCGAC
scaffold_38	forward	CTAACCCTAACCCTAACCCTAACCCTAACCCTAACCCTAACCCTAACCCTAACCCTAACCCTAACCCTAACCCTAACAGATTTCTCTTATCTGATAGATC
scaffold_39	reverse	TCAGAATCTTGACTTGTCTTCATGGGTTAGGGTTAGGGTTAGGGTTAGGGTTAGGGTTAGGGTTAGGGTTAGGGTTAGGGTTAGGGTTAGGGTTAGGGTT
scaffold_40	reverse	GTAAGCATGTCTTCTATGTTATGAGGGTTAGGGTTAGGGTTAGGGTTAGGGTTAGGGTTAGGGTTAGGGTTAGGGTTAGGGTTAGGGTTAGGGTTAGGGT
scaffold_43	reverse	TGGATGTTGGATGTTGGATGTTTTTAGGGTTAGGGTTAGGGTTAGGGTTAGGGTTAGGGTTAGGGTTAGGGTTAGGGTTAGGGTTAGGGTTAGGGTTAGG
scaffold_50	reverse	AAGTTGTAAACTTTTACTTTAAATAGGGTTAGGGTTAGGGTTAGGGTTAGGGTTAGGGTTAGGGTTAGGGTTAGGGTTAGGGTTAGGGTTAGGGTTAGGG
scaffold_51	forward	CCCTAACCCTAACCCTAACCCTAACCCTAACCCTAACCCTAACCCTAACCCTAACCCTAACCCTAACCCTAACCCTACTCTTTATCTTATCTATCATACA
scaffold_58	reverse	TTTATACTCTTACTATTGTGAAATTAGGGTTAGGGTTAGGGTTAGGGTTAGGGTTAGGGTTAGGGTTAGGGTTAGGGTTAGGGTTAGGGTTAGGGTTAGG
scaffold_63	forward	CTAACCCTAACCCTAACCCTAACCCTAACCCTAACCCTAACCCTAACCCTAACCCTAACCCTAACCCTAACCCTAATAAGTTGATGTATATTCAGATCAA
scaffold_85	reverse	GCATCTGTAAAAGTTGAGAAACAAGGTTAGGGTTAGGGTTAGGGTTAGGGTTAGGGTTAGGGTTAGGGTTAGGGTTAGGGTTAGGGTTAGGGTTAGGGTT
scaffold_101	forward	TAACCCTAACCCTAACCCTAACCCTAACCCTAACCCTAACCCTAACCCTAACCCTAACCCTAACCCTAACCCTAAAACGCTATAACGCTATAACGCTATA
scaffold_121	reverse	AAGTGAAACTTAGGGTTAGGGTTAGGGTTAGGGTTAGGGTTAGGGTTAGGGTTAGGGTTAGGGTTAGGGTTAGGGTTAGGGTTAGGGTTAGGGTTAGGGT
scaffold_130	reverse	CTGACTGACATCAAAGTAAATATAAGGGTTAGGGTTAGGGTTAGGGTTAGGGTTAGGGTTAGGGTTAGGGTTAGGGTTAGGGTTAGGGTTAGGGTTAGGG
scaffold_196	forward	CCCTAACCCTAACCCTAACCCTAACCCTAACCCTAACCCTAACCCTAACCCTAACCCTAACCCTAACCCTAACCTATACTCAAAGACATCTTTTCACTTT
scaffold_216	forward	TAACCCTAACCCTAACCCTAACCCTAACCCTAACCCTAACCCTAACCCTAACCCTAACCCTAACCCTAACCCTAAGTCTGACAGATGAAGATGAATGTTT
scaffold_256	reverse	GACTTAGACTTAGACTTAGACTTAGACTTAGGGTTAGGGTTAGGGTTAGGGTTAGGGTTAGGGTTAGGGTTAGGGTTAGGGTTAGGGTTAGGGTTAGGGT
scaffold_258	forward	CTAACCCTAACCCTAACCCTAACCCTAACCCTAACCCTAACCCTAACCCTAACCCTAACCCTAACCCTAACCCTGATGCGGACGGGTTTCGTGATAGAAG
scaffold_276	reverse	CCCTATGACACTGACTGAACATCAAGGGTTAGGGTTAGGGTTAGGGTTAGGGTTAGGGTTAGGGTTAGGGTTAGGGTTAGGGTTAGGGTTAGGGTTAGGG
scaffold_290	reverse	GAAGAGATCTTGATAATTTGTGATGTTAGGGTTAGGGTTAGGGTTAGGGTTAGGGTTAGGGTTAGGGTTAGGGTTAGGGTTAGGGTTAGGGTTAGGGTTA
scaffold_301	forward	TCATAAAATGACTGTATAAAAGTCAAGTATACACACAATAAATAACTAACTTCATGACTTAAAAATCTTATATTGTTTTTAGTACTTCTTGTTATAGATT
scaffold_398	reverse	ATAAATGACTTTTACAAACATTTAACTTAGGGTTAGGGTTAGGGTTAGGGTTAGGGTTAGGGTTAGGGTTAGGGTTAGGGTTAGGGTTAGGGTTAGGGTT

Telomeres found: 23 (9 forward, 14 reverse)
