scaffold_15	forward	AGGCAGTAGGAACACTTTGTTCGTGCTCATCATTTACCACAACCAACGTCACCCTCATATTGCAGACTTAACCCTAACCCTAACCCTAACCTGTATCTTC
scaffold_45	forward	TGTAGGCAGTTGGAATACTTTGTTCGTGCTCATCGGTTACCACAACCAACGTCACCCTCATATTGCAGACTTAACCCTAACCCTAACCCTAGAAAATTGT
scaffold_49	forward	CCCTAACCCTAACCCTAACCCTAACCCTAACCCTAACCCTAACCCTAACCCTAACCCTAACCCTAACCCTAACCCTAACCCTAACCCATAAGAGTATTCT
scaffold_52	reverse	GTTTTTTTCTTAGGGTTAGGGTTAAGTCTGCAATATGAGGGTGACGTTGGTTGTGGTAATTGATGAGCACGAACAAAGTATTCCTACTGCCTACAGTCAA
scaffold_72	reverse	AGTTAGGGTTAGGGTTAGGGTTAAGTCTGCAATATGAGGGTGACGTTGGTTGTGGTAATTGATGAGCACGAACAAAGTGTTCCTACTGTCTACAGTCAAG
scaffold_73	reverse	TAGGGTTAAGTTAGGGTTAGGGTTAAGTCTGCAATATGAGGGTGACGTTGGTTGTGGTAATTGATGAGCACGAACAAAGTATTCCTACTGCCTACAGTCA
scaffold_74	forward	GTAGGCAGTTGGAATACTTTGTTCGTGCTCATCGGTTACCACAACCAACGTCACCCTCATATTGCAGACTTAACCCTAACCCTAACCCTAAGATTCTCAA
scaffold_76	forward	TACTTGACTGTAGACAGTAGGAACACTTTGTTCGTGCTCATCAATTACCACAACCAACGTCACCCTCATATTGCAGACTTAACCCTAACCCTATTATAGA
scaffold_79	forward	GTAGGCAGTTGGAATACTTTGTTCGTGCTCATCGGTTACCACAACCAACGTCACCCTCATATTGCAGACTTAACCCTAACCCTAACCCTAATGGTTTGGA
scaffold_82	forward	AACTCTAACCCCTAACTTCTAACCCAAACCCCGATACGGTAGGCTTCGCTATAGAAGACCTTACCAGGGCTTGGCGCCTGCGCTCTTTTGATAAGAGGCA
scaffold_86	forward	CTAACCCTAACCCTAACCCTAACCCTAACCCTAACCCTAACCCTAACCCTAACCCTAACCCTAACCCTAACCCTAACCCTAACCCTAACCCAGACTTAAC
scaffold_90	reverse	AAGTTTGGGTTAGGGTTAGGGTTAGGGTTAAGTCTGCAATATGAGGGTGACGTTGGTTGTGGTAACCGATGAGCACGAACAAAGTATTCCAACTGCCTAC
scaffold_96	reverse	TTAGGGTTAGGGTTAGGGTTAAGTCTGCAATATGAGGGTGACGTTGGTTGTGGTAACCGATGAGCACGAACAAAGTATTCCAACTGCCTACAGCCAAGTA
scaffold_101	reverse	ACCATATCGGGGTTAGGGTTAGGGTTAGGGTTAAGTCTGCAATATGAGGGTGACGTTGGTTGTGGTAACCGATGAGCACGAACAAAGTATTCCAACTGCC
scaffold_102	reverse	CTGCATTTTTGGGTTAGGGTTAGGGTTAGGGTTAGGGTTAGGGTTAGGGTTAGGGTTAGGGTTAGGGTTAGGGTTAGGGTTAGGGTTAGGGCTGTTAGGG
scaffold_126	reverse	TTGTAGCTATAGGGTTAGGGTTAAGTCTGCAATATGAGGGTGACGTTGGTTGTGGTAACCGATGAGCACGAACAAAGTATTCCAACTGCCTACAGCCAAG
scaffold_127	forward	ACCCTAACCCTAACCCTAACCCTAACCCTAACCCTAACCCTAACCCTAACCCTAACCCTAACCCTAACCCTAACCCTAACCCTAACCCTAAGTTCAGAAA
scaffold_134	forward	GTAGGCAGTAGGAACACTTTGTTCGTGCTCATCATTTACCACAACCAACGTCACCCTCATATTGCAGACTTAACCCTAACCCTAACCCTAAATTTCAGCA
scaffold_144	reverse	ACTAAAAAATGGGTTAGGGTTAGGGTTAGGGTTAAGTCTGCAATATGAGGGTGACGTTGGTTGTGGTAACCGATGAGCACGAACAAAGTATTCCAACTGC
scaffold_192	forward	CCTAACCCTAACCCTAACCCTAACCCTAACCCTAACCCTAACCCTAACCCTAACCCTAACCCTAACCCTAACCCTAACCCTAACCCTAAGTCAGTTACTA
scaffold_231	reverse	TAGGGTTAGGGTTAGGTCTGCAATATGAGGGTGACGTTGGTTGTGGTAACCGATGAGCACGAACAAAGTATTCCAACTGCCTACAGCCAAGTAAAACAGT
scaffold_234	reverse	GACTGAACAGACATGACTCCAACGTCAAAGGTTAGGGTTAAGTCTGCAATATGAGGGTGACGTTGGTTGTGGTAATTGATGAGCACGAACAAAGTATTCC

Telomeres found: 22 (11 forward, 11 reverse)
