scaffold_6	reverse	TCTGAGTATAAGGGTTAGGGTTAGGGTTAGGGTTAGGGTTAGGGTTAGGGTTAGGGTTAGGGTTAGGGTTAGGGTTAGGGTTAGGGTTAGGGTTAGGGTT
scaffold_16	reverse	AGAGTTAGGTTACAGCGCTTTTTAGAAGTTCTGCGCCAGACGGAAATTTGACGAAAATTTCTAGAAATTTTCTTTCAAAGATCAAAAACACACAAATTCA
scaffold_30	reverse	TCAGGTTCAGGTTAGGGTTAGGGTTAGGGTTAGGGTTAGGGTTAGGGTTAGGGTTAGGGTTAGGGTTAGGGTTAGGGTTAGGGTTAGGGTTAGGGTTAGG
scaffold_33	forward	CCCTAACCCTAACCCTAACCCTAACCCTAACCCTAACCCTAACCCTAACCCTAACCCTAACCCTAACCCTAACCCTAACCCTAACCCTAACACTCTAGAC
scaffold_51	forward	CCCTAACCCTAACCCTAACCCTAACCCTAACCCTAACCCTAACCCTAACCCTAACCCTAACCCTAACCCTAACCCTAACCCTAACCCTAACGCGATTGAG
scaffold_88	reverse	CTTAACATTGGGTTAGGGTTAGGGTTAGGGTTAGGGTTAGGGTTAGGGTTAGGGTTAGGGTTAGGGTTAGGGTTAGGGTTAGGGTTAGGGTTAGGGTTAG
scaffold_148	forward	TGGGCTTACTAATACAGTGAATCTGACTTAGAAAAAATTTCAGAAATCGAGTGATTCTAACGACTTTTGCTCCATACTCTTACCTTAGGTAACTAACTCC
scaffold_180	reverse	TGTTGAGCGGGGTTAGGGTTAGGGTTAGGGTTAGGGTTAGGGTTAGGGTTAGGGTTAGGGTTAGGGTTAGGGTTAGGGTTAGGGTTAGGGTTAGGGTTAG
scaffold_205	forward	AACCCTAACCCTAACCCTAACCCTAACCCTAACCCTAACCCTAACCCTAACCCTAACCCTAACCCTAACCCTAACCCTAACCCTAACCCTCATGATGTTG
scaffold_263	reverse	GTGCTGGCTTTGGGTTAGGGTTAGGGTTAGGGTTAGGGTTAGGGTTAGGGTTAGGGTTAGGGTTAGGGTTAGGGTTAGGGTTAGGGTTAGGGTTAGGGTT
scaffold_297	reverse	TCCGACACCTGGGTTAGGGTTAGGGTTAGGGTTAGGGTTAGGGTTAGGGTTAGGGTTAGGGTTAGGGTTAGGGTTAGGGTTAGGGTTAGGGTTAGGGTTA
scaffold_298	forward	TAACCCTAACCCTAACCCTAACCCTAACCCTAACCCTAACCCTAACCCTAACCCTAACCCTAACCCTAACCCTAACCCTAACCCTAACCCTCTTGAAAAT
scaffold_327	forward	TAACCCTAACCCTAACCCTAACCCTAACCCTAACCCTAACCCTAACCCTAACCCTAACCCTAACCCTAACCCTAACCCTAACCCTAACCCTTGCAGTTAA
scaffold_352	forward	TTGACTGTAGGCAGTAGGAACACCTCGTTTGTGCTCATCATTTTCACAACCAACGCCACCCTCATATTTCAGACTTAACCCTAACCCTAACTCTAAATTT
scaffold_385	forward	ACCCTAACCCTAACCCTAACCCTAACCCTAACCCTAACCCTAACCCTAACCCTAACCCTAACCCTAACCCTAACCCTAACCCTAACCCTAATTTTCATCA
scaffold_437	reverse	GTTAACAGCAGGGTTAGGGTTAGGGTTAGGGTTAGGGTTAGGGTTAGGGTTAGGGTTAGGGTTAGGGTTAGGGTTAGGGTTAGGGTTAGGGTTAGGGTTA
scaffold_466	forward	AACCCTAACCCTAACCCTAACCCTAACCCTAACCCTAACCCTAACCCTAACCCTAACCCTAACCCTAACCCTAACCCTAACCCTAACCCTGTGTCACAGT
scaffold_506	forward	ACCCTAACCCTAACCCTAACCCTAACCCTAACCCTAACCCTAACCCTAACCCTAACCCTAACCCTAACCCTAACCCTAACCCTAACCCTGCAGTCTGTAT
scaffold_509	forward	TAACCCTAACCCTAACCCTAACCCTAACCCTAACCCTAACCCTAACCCTAACCCTAACCCTAACCCTAACCCTAACCCTAACCCTAACCCCATGTACCAC
scaffold_549	forward	GTAGACACCACGTGATTGCGGAGTAATTAGTGTACCTAAATTTGTAAGGGGTAATCATAGTTATTGAAGTCACTCCGTGTAACCCTAACCACATCTATGC
scaffold_653	forward	CTAACCCTAACCCTAACCCTAACCCTAACCCTAACCCTAACCCTAACCCTAACCCTAACCCTAACCCTAACCCTAACCCTAACCCTAACCCGAAAACACC
scaffold_686	reverse	CAAGAGTCGTAGGGTTAGGGTTAGGGTTAGGGTTAGGGTTAGGGTTAGGGTTAGGGTTAGGGTTAGGGTTAGGGTTAGGGTTAGGGTTAGGGTTAGGGTT

Telomeres found: 22 (13 forward, 9 reverse)
