scaffold_22	forward	CTAACCCTAACCCTAACCCTAACCCTAACCCTAACCCTAACCCTAACCCTAACCCTAACCCTAACCCTAACCCTAACGCAGATGATAGACCCACTGAAGA
scaffold_58	forward	AACCCTAACCCTAACCCTAACCCTAACCCTAACCCTAACCCTAACCCTAACCCTAACCCTAACCCTAACCCTAAGAATATCTACAGCTTAAAACCCCAAC
scaffold_78	reverse	CAGGATAGTAGAGCCCACATAGATAGGGTTAGGGTTAGGGTTAGGGTTAGGGTTAGGGTTAGGGTTAGGGTTAGGGTTAGGGTTAGGGTTAGGGTTAGGG
scaffold_85	reverse	CCCCGCAGAAAGCTTTCACTTAGGGGTTAGGGTTAGGGTTAGGGTTAGGGTTAGGGTTAGGGTTAGGGTTAGGGTTAGGGTTAGGGTTAGGGTTAGGGTT
scaffold_107	forward	CCTAACCCTAACCCTAACCCTAACCCTAACCCTAACCCTAACCCTAACCCTAACCCTAACCCTAACCCTAACCCTAAATTTCTTCTTCTATCAGCAGTAA
scaffold_120	reverse	CGCAGGACTACAAATAGTCCACTTACTCGTATGCACGGGGTTTCCGCGCACACTGGGTTTCCGCGCACTCTAACTAGAAAGGTTAGTTACAGATAGTATC
scaffold_127	reverse	ACCGCTAACCGCTAAGTATATAATTAGGGTTAGGGTTAGGGTTAGGGTTAGGGTTAGGGTTAGGGTTAGGGTTAGGGTTAGGGTTAGGGTTAGGGTTAGG
scaffold_132	forward	CTAACCCTAACCCTAACCCTAACCCTAACCCTAACCCTAACCCTAACCCTAACCCTAACCCTAACCCTAACCCTAACTCTAACTCTAACCCTAACCCTAA
scaffold_141	reverse	ACGCCACAAAAGACTATTACAACAGGGTTAGGGTTAGGGTTAGGGTTAGGGTTAGGGTTAGGGTTAGGGTTAGGGTTAGGGTTAGGGTTAGGGTTAGGGT
scaffold_142	reverse	CCGGTTTGCACTTAGACATATCATACTCGTATGCACGGGGTTTCCGCGCACACTGGGTTTCCGCGCACTCTAACTAGAAAGGTTAGTTACAGATAGTATC
scaffold_149	reverse	GGCGGCAATACGTTGAGTGAACAAGGGTTAGGGTTAGGGTTAGGGTTAGGGTTAGGGTTAGGGTTAGGGTTAGGGTTAGGGTTAGGGTTAGGGTTAGGGT
scaffold_150	forward	CCCTAACCCTAACCCTAACCCTAACCCTAACCCTAACCCTAACCCTAACCCTAACCCTAACCCTAACCCTAACCCTGATTAAAAAGCGAAGATGATTGCT
scaffold_168	forward	AACCCTAACCCTAACCCTAACCCTAACCCTAACCCTAACCCTAACCCTAACCCTAACCCTAACCCTAACCCTAACCCGAGCGATCTTATGCAACATGTCT
scaffold_181	reverse	TCACTTTCATTTCGCTGCATAATTTTAGGGTTAGGGTTAGGGTTAGGGTTAGGGTTAGGGTTAGGGTTAGGGTTAGGGTTAGGGTTAGGGTTAGGGTTAG
scaffold_205	reverse	CCAGGTCACGACCACAGAGCGAACTTAGGGTTAGGGTTAGGGTTAGGGTTAGGGTTAGGGTTAGGGTTAGGGTTAGGGTTAGGGTTAGGGTTAGGGTTAG
scaffold_252	forward	TAACCCTAACCCTAACCCTAACCCTAACCCTAACCCTAACCCTAACCCTAACCCTAACCCTAACCCTAACCCTAAGCTGCTATGCGAGAAATTCAATCAC
scaffold_271	forward	CTAACCCTAACCCTAACCCTAACCCTAACCCTAACCCTAACCCTAACCCTAACCCTAACCCTAACCCTAACCCTAAGCATGAAAATCAATCTAGCTTTGT
scaffold_284	reverse	TTACTGCATTTGCTTACTGCATAAATTAGGGTTAGGGTTAGGGTTAGGGTTAGGGTTAGGGTTAGGGTTAGGGTTAGGGTTAGGGTTAGGGTTAGGGTTA
scaffold_322	forward	ATACTATCTGTAACTAACCTTTCTAGTTAGAGTGCGCGGAAACCCAGTGTGCGCGGAAACCCCGTGCATACGAGTATCAGCCACGTACATTCCATGGATT
scaffold_322	reverse	ATTTTCACGAAATCTAGTTGAAATCTCAGGGTTAGGGTTAGGGTTAGGGTTAGGGTTAGGGTTAGGGTTAGGGTTAGGGTTAGGGTTAGGGTTAGGGTTA
scaffold_324	forward	GAGGAAGGATAAATACCCCTAGCGCCAAGCCGCTTCGGCCGGAGCGGAAATAACTAACCGCCGGGGTATACGTATGAACATACGTATGTTCATACGTATG
scaffold_347	reverse	GCCATGTCGATTGGAACGAGGGCGGGGTTAGGGTTAGGGTTAGGGTTAGGGTTAGGGTTAGGGTTAGGGTTAGGGTTAGGGTTAGGGTTAGGGTTAGGGT
scaffold_363	reverse	AAGAATTTGACGTTAAAAACATTAAGGGTTAGGGTTAGGGTTAGGGTTAGGGTTAGGGTTAGGGTTAGGGTTAGGGTTAGGGTTAGGGTTAGGGTTAGGG
scaffold_397	forward	TAACCCTAACCCTAACCCTAACCCTAACCCTAACCCTAACCCTAACCCTAACCCTAACCCTAACCCTAACCCTGTTGACCCCTCACTCAACTGACATCAA
scaffold_403	reverse	ATCACCCGCAAGAATTCAATCGGTACTCGTATGCACGGGGTTTCCGCGCACACTGGGTTTCCGCGCACTCTAACTAGAAAGGTTAGTTACAGATAGTATC
scaffold_410	reverse	TCAGATAGTAGAGACTGTGTGAAAGACTTTAGTTTAGTGCTTTTGCTTCATAGTCTGTTAACTGTTATCAGCGAGTCGTTGTTAGTTATTTCAGTCAAAA
scaffold_439	reverse	ATGAATCAGATCATCGACACGATTTAGGGGTTAGGGTTAGGGTTAGGGTTAGGGTTAGGGTTAGGGTTAGGGTTAGGGTTAGGGTTAGGGTTAGGGTTAG
scaffold_474	reverse	TTTGATTGAGAAAGTGATAATTGATTAGGGTTAGGGTTAGGGTTAGGGTTAGGGTTAGGGTTAGGGTTAGGGTTAGGGTTAGGGTTAGGGTTAGGGTTAG
scaffold_477	reverse	AATGGAGTACGTATACGGAGTACACATACGTATACCCCGGCGGTTAGTTATTTCCGCTCCGGCCGAAGCGGCTTGGCGCTAGGGGTATTTATCCTTCCTC
scaffold_533	forward	AAAACATAACTAACAACTTGTATTAAAAAATCTACGAAAACAGGTGTTTTAAATAAAATCATTAGTTTTAGTGTTGGCTTTAGTTATAATTATGCTTGTA
scaffold_564	reverse	ATGCTTGAAAAGAATAAATTTGTGGGTTAGGGTTAGGGTTAGGGTTAGGGTTAGGGTTAGGGTTAGGGTTAGGGTTAGGGTTAGGGTTAGGGTTAGGGTT
scaffold_574	reverse	ATGTAGTGAAGAATTATTATGTCTTTTACAAGAAAGTCAATACATCGAACTATGTTGTCAGATTGTTAGTTAATGATAACTTCATCAGCTCTGATATTGA
scaffold_587	reverse	AGGTTTTAGGGCTAGGGCTAGGGCTAGGGTTAGGGTTAGGGTTAGGGTTAGGGTTAGGGTTAGGGTTAGGGTTAGGGTTAGGGTTAGGGTTAGGGTTAGG
scaffold_588	reverse	GGGTTAGGGTTAGGGTTAGGGTTAGGGTTAGGGGTTAGGGTTAGGGTTAGGGTTAGGGTTAGGGTTAGGGTTAGGGTTAGGGTTAGGGTTAGGGTTAGGG
scaffold_597	reverse	GAACCTACAGTCTACAGACTACCTAGGGTTAGGGTTAGGGTTAGGGTTAGGGTTAGGGTTAGGGTTAGGGTTAGGGTTAGGGTTAGGGTTAGGGTTAGGG
scaffold_638	forward	CTAACCCTAACCCTAACCCTAACCCTAACCCTAACCCTAACCCTAACCCTAACCCTAACCCTAACCCTAACCCTAACAAAATGAACACTAAAGTCGATGC
scaffold_647	reverse	TTGATGATCAACAAGAGCAATGAAAATTTAGGGTTAGGGTTAGGGTTAGGGTTAGGGTTAGGGTTAGGGTTAGGGTTAGGGTTAGGGTTAGGGTTAGGGT
scaffold_684	reverse	GACAGAAGAATGAAAAGAACGAGAGGGTTAGGGTTAGGGTTAGGGTTAGGGTTAGGGTTAGGGTTAGGGTTAGGGTTAGGGTTAGGGTTAGGGTTAGGGT
scaffold_715	reverse	ATTAACTCAAGATTCAAGAAAACATTAGGGTTAGGGTTAGGGTTAGGGTTAGGGTTAGGGTTAGGGTTAGGGTTAGGGTTAGGGTTAGGGTTAGGGTTAG
scaffold_742	reverse	CTTTATTCAGTTGACTAAAAATGAAGGGTTAGGGTTAGGGTTAGGGTTAGGGTTAGGGTTAGGGTTAGGGTTAGGGTTAGGGTTAGGGTTAGGGTTAGGG
scaffold_797	reverse	AATTTTGATTCATGAATTCAAAGAATTTAGGGTTAGGGTTAGGGTTAGGGTTAGGGTTAGGGTTAGGGTTAGGGTTAGGGTTAGGGTTAGGGTTAGGGTT
scaffold_961	reverse	ACTTAACATAATTCATTCTTCAAAGTTAGGGTTAGGGTTAGGGTTAGGGTTAGGGTTAGGGTTAGGGTTAGGGTTAGGGTTAGGGTTAGGGTTAGGGTTA
scaffold_1095	reverse	AAATTTTGACGTTAGTTAAAGTCGCGTCGCGCTGTTTTAACTGTTCAATGAACTTCTTGTTTTGACTGAATTGAGATGTAACGAAAGTGAAAGATCTCTT

Telomeres found: 43 (13 forward, 30 reverse)
