scaffold_14	forward	ACAGTAGGAACACTTTGTTCGTGCTCATCAATTACCACAACCAACGTCACCCTCATATTGCAGACTTAACCCTAACCGACAAGCATTCTCTAGAACCTTG
scaffold_45	reverse	ACTCAACTTGTCTGAGGGTTAGGGTTAGGGTTAGGGTTAGGGTTAAGTCTGCAATATGAGGGTGACGTTGGTTGTGGTAATTGATGAGCACGAACAAAGT
scaffold_51	reverse	GGGATATTTGTTAGGGTTAGGGTTAGGGTTAAGTCTGCAATATGAGGGTGACGTTGGTTGTGGTAATTGATGAGCACGAACAAAGTGTTCCTACTGTCTA
scaffold_53	forward	CAGTAGGAACACTTTGTTCGTGCTCATCAATTACCACAACCAACGTCACCCTCATATTGCAGACTTAACCCTAACCCATTTTCATATTGCAGACTTAACT
scaffold_58	forward	CACTTTGTTCGTGCTCATCAATTACCACAACCAACGTCACCCTCATATTGCAGACTTAACCCTAACCCTAACCCTAAGTACTTGAAATTAGGCTGGGAGA
scaffold_68	reverse	ATTCAAAGTCTGCTAATAACTCAGTTAGGGTTAAGTCTGCAATATGAGGGTGACGTTGGTTGTGGTAATTGATGAGCACGAACAAAGTGTTCCTACTGTC
scaffold_70	reverse	GTTTTGTGTATGAATGATCAGATAGGGTTAGGGTTAGGGTTAGGGTTAGGGTTAAGTCTGCAATATGAGGGTGACGTTGGTTGTGGTAATTGATGAGCAC
scaffold_72	forward	CCCTAACCCTAACCCTAACCCTAACCCTAACCCTAACCCTAACCCTAACCCTAACCCTAACCCTAACCCTAACCCTATTTAAATGCTTAGACTGTAGTTT
scaffold_78	forward	ACTTTGTTCGTGCTCATCAATTACCACAACCAACGTCACCCTCATATTGCAGACTTAACCCTAACCCTAACCCTATAGTCTTTCAACAACTAATCAACAA
scaffold_80	reverse	TATACCAACATAGTCAGAATAAAGTTAGGGTTAGGGTTAGGGTTAAGTCTGCAATATGAGGGTGACGTTGGTTGTGGTAATTGATGAGCACGAACAAAGT
scaffold_81	forward	TGCTCATCAATTACCACAACCAACGTCACCCTCATATTGCAGACTTAACCCTAACCCTAACCCTAACCCTAACCCTAACCCTTTTGCTCTTTTAAAAAAA
scaffold_86	forward	CTTTGTTCGTGCTCATCAATTACCACAACCAACGTCACCCTCATATTGCAGACTTAACCCTAACCCTAACCCTAACCTAATTTATTATAAATCTTTCAAA
scaffold_92	forward	CCTAACCCTAACCCTAACCCTAACCCTAACCCTAACCCTAACCCTAACCCTAACCCTAACCCTAACCCTAACCCTAATGTGTTAAGCAGATGCGGTTGAT
scaffold_95	forward	TTTGTTCGTGCTCATCAATTACCACAACCAACGTCACCCTCATATTGCAGACTTAACCCTAACCCTAACCCTAACCCAAAGCAACAAATAATTATATTTT
scaffold_103	forward	ACTTTGTTCGTGCTCATCAATTACCACAACCAACGTCACCCTCATATTGCAGACTTAACCCTAACCCTAACCCTAAGAAAGAAATACAATTTAAAACTGA
scaffold_114	forward	GCTCATCAATTACCACAACCAACGTCACCCTCATATTGCAGACTTAACCCTAACCCTAACCCTAACCCTAACCCTAAAATTTGAGAGGGTCGCTAACTTA
scaffold_119	reverse	AGATCCCCACGGGTCTTTGTGCAACTTAGGGTTAGGGTTAGGGTTAAGTCTGCAATATGAGGGTGACGTTGGTTGTGGTAATTGATGAGCACGAACAAAG
scaffold_122	forward	CCTAACCCTAACCCTAACCCTAACCCTAACCCTAACCCTAACCCTAACCCTAACCCTAACCCTAACCCTAACCCTAAACTATAAATCAGATATCACAGAG
scaffold_123	reverse	ACACACTATTCTTTACATAAATACTTAGGGTTAGGGTTAGGGTTAGGGTTAGGGTTAGGGTTAGGGTTAGGGTTAGGGTTAGGGTTAGGGTTAGGGTTAG
scaffold_131	forward	CTTTGTTCGTGCTCATCAATTACCACAACCAACGTCACCCTCATATTGCAGACTTAACCCTAACCCTAACCCTAACATACAGAGTAGAGAATACTTCTTT
scaffold_229	forward	ACAGTAGGAACACTTTGTTCGTGCTCATCAATTACCACAACCAACGTCACCCTCATATTGCAGACTTAACCCTAACCTTTGACGTTGGAGTCATGTCTGT
scaffold_249	reverse	GGTTAGGGTTAAGTCTGCAATATGAGTTAGGGTTAGGGTTAGGGTTAGGGTTAGGGTTAGGGTTAGGGTTAGGGTTAGGGTTAGGGTTAGGGTTAGGGTT

Telomeres found: 22 (14 forward, 8 reverse)
